%%%%%%%%%%%
%P......%.%
%%%%%%%...%
%...%.%.%.%
%.%...%%%.%
%...%.%%..%
%%%......%%
%.%%.%%%..%
%..%..%%.%%
%%....%...%
%%%%%%%%%%%
