%%%%%%%%%%%%%%%%%%%%
%P.%.%%%%.%%%.%.%%%%
%.%%%%.%.%%.%.%%...%
%.%....%%%%%..%..%.%
%%..%...%%.%.%....%%
%%..%%.%%%.%.%.%%%.%
%....%...%..%.%.%%.%
%..%..%...%%.%.%.%.%
%%%..%%%%.%%%...%..%
%..%..%....%.%%.%%%%
%%.%%%.%.%%%%%%%.%%%
%%.%%.....%%%%..%.%%
%%.%..%%%..%.%%%%%%%
%..%.%...%%%%%..%..%
%.%..%%%%%..%.%%.%%%
%..%.%...%%.%..%...%
%.%%%..%...%..%%%%%%
%.%..%%%...%%%..%%%%
%.%...%..%.%..%%%..%
%%%%%%%%%%%%%%%%%%%%
