%%%%%%%%%%%
%%P.%..%..%
%.%%..%%%.%
%...%.....%
%.%..%%%.%%
%.%..%%%%.%
%%....%.%.%
%..%.%.%%.%
%..%%%..%.%
%%.%.%.%.%%
%%%%%%%%%%%
