%%%%%%%%%%%
%%P.......%
%%.%...%.%%
%...%.%...%
%.%..%..%.%
%.%.%.%.%.%
%.%...%%..%
%...%.%%%.%
%.%.......%
%..%%.%.%%%
%%%%%%%%%%%
