%%%%%%%%%%
%P..%...%%
%%%.%.%%.%
%.%......%
%.%%%.%.%%
%%.%%.%..%
%%%%..%.%%
%%%..%.%.%
%.%.%.%.%%
%%%%%%%%%%
