%%%%%%%%%%%
%P........%
%.%%%.%.%.%
%...%...%.%
%.%.%%%.%%%
%...%.....%
%.%%%.%%.%%
%..%...%..%
%%...%%%.%%
%..%.%....%
%%%%%%%%%%%
