%%%%%%%%%%%
%P..%.%.%.%
%%%...%...%
%%......%.%
%%...%....%
%%.....%..%
%.%..%..%.%
%........%%
%%....%...%
%...%..%.%%
%%%%%%%%%%%
