%%%%%%%%%%%%%%%
%P....%...%..%%
%.%%%%%%%%%%.%%
%...%....%%%..%
%.%.%%%%%%.%%%%
%.%....%..%...%
%.%%%%%%%.%.%%%
%.%.%.....%...%
%.....%.%.%.%%%
%%%.%.%.%.%%%.%
%..%.%%....%%.%
%......%..%.%.%
%.%%%%.%%.%...%
%.%...%..%%.%.%
%%%%%%%%%%%%%%%
