%%%%%%%%%%%%%%%
%P%%..%.......%
%...%%..%%%%.%%
%.%..%.%.%....%
%.%%.%...%%.%%%
%.....%%.%.%..%
%%%%.%%..%%%%%%
%.%....%......%
%....%..%.%.%%%
%%%.%%..%.%%.%%
%......%%%..%%%
%%%.%%%%.%%%%.%
%...%%..%.%...%
%%...%..%.%...%
%%%%%%%%%%%%%%%
