%%%%%%%%%%%%%%%%%%%%
%P.....%..%...%....%
%.%%%.%%%%.%%..%%.%%
%....%%.%.%%.%.....%
%%%.%.%......%..%..%
%.%...%%%.%.%..%.%.%
%%....%.%%%%..%%..%%
%.%%%..%%.%.%.%...%%
%....%%..%.%.%..%..%
%.%%%.%..%..%.%.%%.%
%.%..%...%%.%..%..%%
%.%%.%%%.%%%.%%%%.%%
%%.%......%...%.%%.%
%...%%%%..%%.%%%%.%%
%.%%.%.%%%%.%.%.%..%
%.....%....%.%.%%%%%
%%.%%%..%%.%.%%%.%.%
%.%%...%...%%%..%%%%
%%%.%%..%%%.%.%..%.%
%%%%%%%%%%%%%%%%%%%%
