%%%%%%%%%%
%P%......%
%.%.%%..%%
%%%..%%%%%
%%%%.%%%.%
%%.%..%..%
%%.%..%.%%
%%%%.....%
%....%.%%%
%%%%%%%%%%
