%%%%%%%%%%
%P.....%.%
%..%%....%
%%..%.%%.%
%.%...%..%
%.%.%%%.%%
%...%....%
%.%.%.%..%
%.......%%
%%%%%%%%%%
