%%%%%%%%%%%%%%%
%P.%%%%...%.%.%
%..%.%%%%%.%.%%
%%......%....%%
%..%%%.%%%%.%%%
%%......%...%.%
%.%.%%%..%..%.%
%..%....%%...%%
%%..%.%.%.%%..%
%%...%.%.%....%
%%.......%.%.%%
%.%%.%..%.%.%.%
%.%.%.%%.%%.%.%
%%....%.%.....%
%%%%%%%%%%%%%%%
