%%%%%%%%%%%%%%%
%%P%%%%...%%..%
%%.%.%%%%%%.%.%
%%.%.....%....%
%..%%%.%%.%...%
%.......%.%%%.%
%%%..%%..%..%.%
%....%%.%.%%%.%
%............%%
%.%%%%.%%%....%
%%%..%...%.%.%%
%...%%..%...%.%
%%%.%%%.%%%.%.%
%%..%..%%.%...%
%%%%%%%%%%%%%%%
