%%%%%%%%%%%
%P%..%.%..%
%.%..%.%%.%
%%.%......%
%.%%.%%%%%%
%.%.....%.%
%.%%%%.%%.%
%..%%....%%
%%..%%%.%.%
%.%...%..%%
%%%%%%%%%%%
