%%%%%%%%%%%
%P%%...%..%
%%%%.%%%%.%
%.%%..%...%
%%%%.%.%..%
%..%...%%.%
%.%.%%%%.%%
%..%%....%%
%%.%%...%%%
%%..%%.%..%
%%%%%%%%%%%
