%%%%%%%%%%
%P%.....%%
%.%..%.%%%
%..%.....%
%..%..%%.%
%..%..%..%
%...%.%.%%
%.%...%..%
%.%.....%%
%%%%%%%%%%
