%%%%%%%%%%%%%%%
%P..%%.....%..%
%.....%...%%..%
%%%....%.....%%
%%%.......%...%
%.%..%%%%.....%
%..%....%%.%%.%
%....%%..%....%
%%...%........%
%.......%....%%
%.%%..........%
%.%.....%%..%.%
%....%......%.%
%..%....%..%..%
%%%%%%%%%%%%%%%
