%%%%%%%%%%
%P.....%.%
%.%%.%...%
%.%.....%%
%...%%%..%
%.%.....%%
%..%%%...%
%.%.%%.%.%
%......%.%
%%%%%%%%%%
