%%%%%%%%%%%%%%%%%%%%
%P%%%.%...%%.....%.%
%..%%...%%...%.%%%.%
%%%%%.....%%....%%.%
%..%.%...%.%.%.%%.%%
%%%%%.%%%%%..%..%..%
%.%...%.%%.....%%%%%
%.%%.%%..%%..%%%%..%
%.%..%.%%%..%%%..%.%
%%.%.%%%..%%.%.%%.%%
%%%..%%..%..%%%%.%%%
%%..%.%..%%...%%...%
%%.%..%..%.....%%%.%
%...%..%%.%..%..%.%%
%%.%%%..%%...%%%.%%%
%...%...%.%..%.....%
%.%%.%%%.%.%..%%%.%%
%..%%........%.%%..%
%%.%..%%%..%..%%%%.%
%%%%%%%%%%%%%%%%%%%%
