%%%%%%%%%%%%%%%%%%%%
%P...%.......%.....%
%.%%.%%.%.%%.%.%.%%%
%.%...%%...%.%%.%%.%
%.%.%....%.%..%.%..%
%.%%%%%%%...%.%%..%%
%.%..%.%%%.%%.%.%.%%
%.%%.%.......%.%%..%
%%%..%%.%.%%.....%%%
%.%%%%%%...%%%%%%%.%
%%%%....%%%%...%%%.%
%..%%%.%%.%.%.%...%%
%.%%..%%.%...%%%%.%%
%.%..%%%.%%.%.%.%%.%
%.%.%..%...%..%%.%%%
%.%...%%%%%....%%%.%
%...%%.%.%...%%.%%%%
%%.%%..%%..%%%..%%.%
%....%....%.%..%.%.%
%%%%%%%%%%%%%%%%%%%%
