%%%%%%%%%%%%%%%
%P%.......%.%.%
%%..%%%%%%....%
%.%..%%.%%%..%%
%....%.%%...%.%
%..%.%%%%..%%.%
%.%%..%...%%%%%
%....%%.%%.%..%
%.%.%%%.%%....%
%.%%.%.%%....%%
%..%%....%..%%%
%%%..%.%.%%%..%
%.%.%%%%%...%.%
%....%.%.%....%
%%%%%%%%%%%%%%%
