%%%%%%%%%%%%%%%%%%%%
%P....%...%%......%%
%.%.%.%.%...%.%....%
%%%%%%...%%.%%.%%.%%
%.%.....%...%.%%%%%%
%.%..%%%%%%..%%%...%
%.%.%.%.%%%%%.%..%%%
%%%.%.%.%%..%.%%.%.%
%.%%%...%%%.....%%.%
%..%...%..%.%.%%.%%%
%..%..%.%.%...%%...%
%%.%%%%%%.%...%%.%%%
%..%%.%..%.%%....%%%
%.%.%%.%%%.%%.%%..%%
%.%%..%%.%....%.%%%%
%%%.%%..%.%.%%.%%..%
%...%..%%%%...%%..%%
%..%%...%...%..%%%%%
%..%.%%...%.%%%.%..%
%%%%%%%%%%%%%%%%%%%%
