%%%%%%%%%%%
%P....%..%%
%%....%...%
%...%.%%.%%
%........%%
%%...%.%.%%
%%%..%.%..%
%.%..%%...%
%.....%...%
%.....%...%
%%%%%%%%%%%
