%%%%%%%%%%%%%%%
%P%..%..%.%%.%%
%.%%........%.%
%..%....%.%...%
%%%..%%%%..%.%%
%.%%%..%%%.%%.%
%...%.%.%%%%..%
%%%%.......%%.%
%.%%..%%.%%.%%%
%.%%.%.%..%%..%
%.%%%.%.%%%.%.%
%.%....%%.%...%
%...%...%%%%%.%
%.%.%...%...%.%
%%%%%%%%%%%%%%%
