%%%%%%%%%%%%%%%%%%%%
%%P%.%%.%..%.%..%%.%
%..%....%.%....%.%%%
%.%.%%%.%%%.%....%.%
%%%.%%%%..%.%%%..%%%
%....%.%%.%..%...%%%
%.%.%%...%.%..%%...%
%..%%.%.%%.%%%.%.%.%
%%%.%..%%.%%%..%..%%
%.%%%%%.....%.%..%%%
%%.....%%.%...%....%
%.%.%%.%.%%%.%.%%%%%
%%%...%..%%%%%%.%.%%
%.%.%.%.%.%.%...%%%%
%%..%%.%%%%%%%%%..%%
%%..%.%..%%..%.....%
%..%.%%%%..%...%..%%
%%....%.%%%..%%.%..%
%%%%...%%...%.%%.%%%
%%%%%%%%%%%%%%%%%%%%
