%%%%%%%%%%%%%%%
%P....%......%%
%.%%%%%%.%.%%%%
%.%.%.%..%....%
%%%.%.%%%%%%%%%
%.%.....%.%...%
%.%%%%%%%%....%
%.%..%..%.%..%%
%....%%.%.%%%%%
%.%.%%%.%.%.%.%
%.%%.%.%...%%%%
%....%%%.%%.%.%
%.%%%..%..%.%.%
%........%%.%.%
%%%%%%%%%%%%%%%
