%%%%%%%%%%%
%P........%
%.%%%%%%%.%
%...%...%.%
%.%.%%%.%%%
%...%.....%
%.%%%.%%.%%
%..%...%..%
%%...%%%.%%
%..%.%....%
%%%%%%%%%%%
