%%%%%%%%%%
%P.......%
%.%.%.%%.%
%.%.%.%..%
%.%...%%%%
%.%.%.%..%
%.%...%.%%
%.%.%.%.%%
%.%......%
%%%%%%%%%%
