%%%%%%%%%%%%%%%%%%%%
%P..%.....%..%.%%.%%
%.%..%%.%..%....%%%%
%%%%..%%%%%%%%.%...%
%.%........%%%..%%%%
%%%.%%%.%.%.%%.%.%%%
%.%%%.%...%%%...%..%
%.%...%%%.%.%%.%..%%
%%%.%....%%%%%...%.%
%....%..%.%%..%.%.%%
%.%%..%%%.%..%%%...%
%..%.%.%%..%.%.%%%%%
%...%%.%%%%.%%%%%%.%
%..%.....%%.%%..%.%%
%%.%..%.%%.%.%%%%..%
%.%..%%%.%.%%.%.%..%
%..%%%...%.%%%..%.%%
%%%%%......%..%.%.%%
%..%..%...%..%%%.%.%
%%%%%%%%%%%%%%%%%%%%
