%%%%%%%%%%%
%P..%%%.%.%
%%%%.%..%%%
%.%..%...%%
%......%%%%
%..%.%%%..%
%..%%%.%%%%
%%..%..%%.%
%.%.%%%.%%%
%.......%.%
%%%%%%%%%%%
