%%%%%%%%%%%%%%%
%P%..%........%
%%..%%.%%%%%%.%
%.%.....%...%%%
%....%%%....%%%
%..%.%%%...%..%
%.%%.%.%.%.%..%
%....%.....%%.%
%.%%..%.%.%%.%%
%.%.%%.%.....%%
%...%....%..%%%
%.%.%%.%.%%%..%
%.%.%%.%%%..%.%
%....%.%.%....%
%%%%%%%%%%%%%%%
