%%%%%%%%%%%%%%%
%P%..%........%
%...%..%%%%%%.%
%%%..%..%%..%%%
%..%.%%..%...%%
%...%%%%...%..%
%%.%%%.%.%....%
%..%.%..%%.%..%
%.%%.%..%.%.%.%
%.%.%.%..%.%.%%
%...%%%%.%%.%.%
%.%.%%.%.%%%%.%
%.%.%%%%%%..%.%
%.....%....%%.%
%%%%%%%%%%%%%%%
