%%%%%%%%%%
%P%...%.%%
%.%..%%..%
%.%......%
%.%%..%%.%
%.%...%..%
%...%.%.%%
%.%%.....%
%.%%....%%
%%%%%%%%%%
