%%%%%%%%%%
%P.......%
%%%.%.%..%
%.%...%.%%
%.%.%%%.%%
%.%.%....%
%...%.%.%%
%........%
%%.%...%.%
%%%%%%%%%%
