%%%%%%%%%%%%%%%
%P..%%%..%%...%
%........%%.%.%
%%%.......%...%
%.%...%%...%..%
%.%%%..%%.....%
%..%....%%.%%.%
%.%%%%%..%....%
%.%%..........%
%...%...%....%%
%%..%%........%
%.......%%....%
%.%.........%.%
%%%%%%..%..%..%
%%%%%%%%%%%%%%%
