%%%%%%%%%%%%%%%
%P.........%%.%
%....%.%.%....%
%%%%.%.%%%%%%%%
%.%.%.%%.%.%..%
%.%%.%%%.%.%%.%
%..%%.%.%%..%.%
%..%..%%%...%.%
%%.%%%..%.%...%
%.%%...%%...%.%
%.%.%%..%.%...%
%.%..%%.%%..%.%
%%.%%.%.%%%%%.%
%.%%...%.%%%.%%
%%%%%%%%%%%%%%%
