%%%%%%%%%%%%%%%
%P..%%%...%...%
%..%.%%.%.%%%.%
%%.%..%..%...%%
%..%%%.%%.....%
%..%..%...%%%.%
%%%.%%%%.%..%.%
%..%.%.%%..%%.%
%.........%..%%
%.%%%%.%.%...%%
%%%%.%.....%..%
%....%%.%.%.%.%
%%%.%%...%%.%.%
%%..%..%%..%..%
%%%%%%%%%%%%%%%
