%%%%%%%%%%
%P..%....%
%%%....%%%
%.%.%..%.%
%%.%%%%%%%
%%.%..%..%
%..%%%%%.%
%.%%.....%
%.%..%...%
%%%%%%%%%%
