%%%%%%%%%%%%%%%
%P...%..%%.%%.%
%.%%%%%%%%%..%%
%.....%%%%%%..%
%..%%..%..%%..%
%%..%...%%...%%
%.%.%%%...%%.%%
%%%.......%...%
%.%%.%.%...%%%%
%%.%%%%.%%..%.%
%%%%%...%..%%%%
%%%%..%%%.%%%.%
%..%..%%%%%%.%%
%.%%..%%%.%..%%
%%%%%%%%%%%%%%%
