%%%%%%%%%%%%%%%
%%P......%..%.%
%..%.%%...%.%.%
%%%%%%%%.%..%%%
%....%.....%..%
%..%..%...%.%.%
%..%..%.%%%.%.%
%.%%.....%.%.%%
%%%...%...%%..%
%%.%%%..%%....%
%%%%....%...%.%
%..%%%...%..%%%
%%.%.%%%%%..%.%
%%..%%.%.%..%.%
%%%%%%%%%%%%%%%
