%%%%%%%%%%%%%%%
%P....%.....%.%
%%..%%%%...%.%%
%.....%..%..%.%
%.%%%.%%%.%.%.%
%.%.......%%.%%
%...%%%%%%..%.%
%.%.%.%...%%..%
%.....%.%%%.%.%
%.%%%%.%.%%%..%
%.%.........%%%
%%%%%%%.%%....%
%.%..%..%%%%%.%
%.%.%%...%....%
%%%%%%%%%%%%%%%
