%%%%%%%%%%%%%%%%%%%%
%%P........%%...%..%
%%.%%..%%%....%%%%.%
%%...%%..%%..%..%..%
%..%...%..%%%%%....%
%%%%%..%.%.......%%%
%.%.%.%%...%.%%....%
%.......%.%...%..%.%
%.%.%.....%...%%%..%
%..%%%%%%..%...%..%%
%%%..%%%.%...%.....%
%.%......%..%%..%.%%
%...%%..%.%.....%%.%
%%.%%..%....%%%....%
%......%.%%....%%.%%
%%.%.%.....%...%.%.%
%..%.%%%%..........%
%.......%.%....%..%%
%.%..%%...%.%..%..%%
%%%%%%%%%%%%%%%%%%%%
