%%%%%%%%%%%%%%%
%P.......%....%
%.%%%%%%..%%.%%
%....%%.....%.%
%.%%%..%%%%%%.%
%.%.%%%%.%.%%%%
%.%.%.%..%.%.%%
%....%%%%.%%%.%
%.%.%..%%.%...%
%.%.%.%%%.%.%%%
%.%%%%%....%..%
%..%..%%%%...%%
%.%.%%%...%.%.%
%..%%...%.%%..%
%%%%%%%%%%%%%%%
