%%%%%%%%%%%%%%%%%%%%
%P...%.%...%.%.%..%%
%.%..%.%%%.%.%%..%%%
%.%.%....%%..%.%%%.%
%.%.%.%....%%%%%.%%%
%.%%%%%.%%%%%.%..%.%
%%..%%%%..%%.%%.%%%%
%.....%%...%.....%%%
%%...%%..%..%.%.%%.%
%...%.%%....%%%%%..%
%.%%....%%..%%..%..%
%.%.%%.%..%%...%...%
%.%%%.%..%.%.%.%.%%%
%%.%..%%...%..%%..%%
%.%.%%%.%%..%%..%.%%
%%.%..%%..%...%....%
%%.%%%%.%%%..%%%.%%%
%.%%%%.%.....%..%..%
%%..%%.%......%.%%%%
%%%%%%%%%%%%%%%%%%%%
