%%%%%%%%%%
%P.......%
%%.%.%%%%%
%..%%%%%.%
%%%%..%%%%
%.%..%%%.%
%%%%...%.%
%..%%..%%%
%.%.%.%%.%
%%%%%%%%%%
