%%%%%%%%%%%
%%P......%%
%.%.%.%%%.%
%..%%.....%
%.%...%%%%%
%.%.....%%%
%%%%%%.%%.%
%....%..%.%
%.%%.%%%.%%
%%.%%.%.%.%
%%%%%%%%%%%
