%%%%%%%%%%%
%P...%...%%
%.%%.%.%%.%
%%%%......%
%.%..%%%%%%
%%...%.%..%
%.%%%%.%%.%
%....%....%
%%%%%%%.%.%
%.%.......%
%%%%%%%%%%%
