%%%%%%%%%%%%%%%
%P..%....%....%
%.%%%%%%..%%.%%
%..%%..%....%.%
%...%.%.%%%%%%%
%.%.%%%%%.%...%
%.%.%.%..%.%%.%
%...%%%%%.....%
%.%.%.....%%%.%
%.%.%.%%.%..%%%
%%%%%.%.%.%%..%
%..%....%%.%.%%
%...%%%...%%%.%
%..%%...%...%.%
%%%%%%%%%%%%%%%
