%%%%%%%%%%%
%P........%
%.%%%%%%%.%
%.%..%...%%
%.%%...%..%
%.%..%.%%.%
%.%%.%....%
%....%%.%.%
%.%%....%%%
%...%.%...%
%%%%%%%%%%%
