%%%%%%%%%%%%%%%%%%%%
%P%..%....%....%.%%%
%%%.%%.%.%%%....%..%
%.%..%%...%%%%.%%%.%
%%%%...%.%.%..%%%%.%
%%.%.%%%%%...%..%..%
%.......%%..%%..%%%%
%.%.%%%%.....%%%...%
%.%%%.%..%.%......%%
%..%.%%..%..%..%.%.%
%.%...%%.%.%...%%%.%
%...%%%..%%....%.%.%
%.%..%...%...%.%.%.%
%.%%...%%%.%..%.%%.%
%....%.%.%....%%%%.%
%..%.%%%%%..%.%....%
%...%...%..%.%.%.%.%
%%.%.%%%%..%.%...%%%
%%..%.%.%.%%..%%...%
%%%%%%%%%%%%%%%%%%%%
