%%%%%%%%%%%%%%%%%%%%
%%P%.%%.%..%..%%%.%%
%..%....%.%.%..%...%
%.%.%%%.%%%.%%%..%.%
%%%.%%%%..%...%.%.%%
%....%.%%.%.%%.%%%%%
%.%.%%...%.%..%.%%.%
%..%%.%.%%.%.%.%.%.%
%%%.%..%%.%%%...%..%
%..%%%.%.%%.%.%..%%%
%%.....%%.%...%....%
%....%.%.%.%.%.%%%%%
%.%.%..%%..%%%%.%.%%
%.%%%.%%%%..%...%%%%
%.%.%%%%%..%%%%%..%%
%%...%%.%%%..%.....%
%.......%.%%...%..%%
%..%...%%%...%%.%..%
%...%%..%%%.%.%%.%%%
%%%%%%%%%%%%%%%%%%%%
