%%%%%%%%%%
%P.......%
%.%.%.%%.%
%...%.%..%
%.%.%.%.%%
%.%.%%%..%
%...%.%%%%
%.%.%.%.%%
%........%
%%%%%%%%%%
