%%%%%%%%%%%
%P........%
%.%%%%%.%.%
%.%......%%
%.%%.%.%..%
%....%.%%.%
%.%%.%....%
%....%%.%%%
%.%%....%.%
%...%.%...%
%%%%%%%%%%%
