%%%%%%%%%%
%P.......%
%.%.%%%%.%
%.%%%..%.%
%......%.%
%.%%.%.%.%
%.%..%...%
%.%.%%.%.%
%........%
%%%%%%%%%%
