%%%%%%%%%%%%%%%
%P....%....%%.%
%..%..%%%.%...%
%%....%...%.%%%
%...%.%%.%%...%
%.%....%..%.%.%
%..%.%.%%....%%
%%......%%.%..%
%...%%..%..%%.%
%%.%..%...%..%%
%......%.%..%.%
%%%.%.%%...%%.%
%....%.%......%
%..%.....%...%%
%%%%%%%%%%%%%%%
