%%%%%%%%%%%
%P.%......%
%%..%..%%%%
%%..%.%.%%%
%.%..%%%.%%
%%%%.%..%.%
%%%.%%%.%%%
%.....%...%
%.%.%%%%%%%
%.%%..%..%%
%%%%%%%%%%%
