%%%%%%%%%%%
%P..%.%.%%%
%%%...%...%
%%........%
%.%%.%%...%
%.....%%..%
%%.%....%.%
%...%.%..%%
%%.%..%...%
%%.%.%%%.%%
%%%%%%%%%%%
