%%%%%%%%%%%%%%%%%%%%
%P..%....%.......%.%
%.%..%..%.....%%%%%%
%%%%..%%%%%..%...%.%
%.%......%.....%%.%%
%%%.%%%.%%%%..%%...%
%.%%%.%..%%%.......%
%.%...%%%%...%%%%..%
%....%%%%.......%..%
%.%%....%%.%.%.%%%%%
%%...%.%%..%.%%%...%
%...%%%..%%%.%.%%%%%
%.%.%.%.%%.%%%%%.%.%
%....%%%%%..%%..%.%%
%..%.%.%..%..%%%%..%
%%%%.%.%.%%%%...%..%
%.%%.%.%%.%%%%..%.%%
%...%..%%%%%..%.%.%%
%%.%..%..%.%.%%%.%.%
%%%%%%%%%%%%%%%%%%%%
