%%%%%%%%%%%%%%%%%%%%
%%%P%..%%....%..%..%
%.%.%........%%.%..%
%%...%%%%.%%%....%%%
%%.%..%..%%%..%...%%
%..%.%..%%.....%%..%
%..%.%%..%.%%.%.%%%%
%%.%..%..%%...%%...%
%...%%...%.%%..%...%
%%%%.%..%%..%%.%.%%%
%%..%%.%%%...%..%%%%
%%.%.%%%%..%%..%.%.%
%%..%.%.%.%%%%..%.%%
%..%.%..%.%..%%..%.%
%%.%%%%..%.%.%%..%%%
%....%%.%..%..%.%%%%
%..%.%%...%...%..%.%
%%%%.%%%..%.%.%..%.%
%...%.....%%.%.%...%
%%%%%%%%%%%%%%%%%%%%
