%%%%%%%%%%
%P....%.%%
%..%..%%%%
%....%...%
%.%.%.%.%%
%..%..%%.%
%...%%%..%
%.....%..%
%.%..%...%
%%%%%%%%%%
