%%%%%%%%%%
%P......%%
%.%.%%...%
%.%...%%%%
%...%..%.%
%%.%.....%
%.%...%.%%
%.....%..%
%.....%%.%
%%%%%%%%%%
