%%%%%%%%%%
%P%.%.%..%
%.%%%%..%%
%%.%%%%..%
%....%%%.%
%.%%%%%..%
%..%.%.%%%
%.%%%%.%%%
%....%..%%
%%%%%%%%%%
