%%%%%%%%%%%
%P........%
%.%.%.%%%.%
%...%.%...%
%.%.....%.%
%..%%..%%.%
%.....%%.%%
%%....%..%%
%%.%%.%%..%
%..%......%
%%%%%%%%%%%
