%%%%%%%%%%%%%%%
%P........%...%
%..%.........%%
%.%....%.%%...%
%.....%.......%
%..%.....%.%..%
%...%......%%%%
%%..%.........%
%.%.%..%......%
%..%......%...%
%.............%
%.............%
%...........%.%
%.%..%......%.%
%%%%%%%%%%%%%%%
