%%%%%%%%%%
%%P.%%...%
%...%%.%.%
%.%......%
%%%.%%%%.%
%%%...%..%
%.%...%..%
%....%%%%%
%%.%....%%
%%%%%%%%%%
