%%%%%%%%%%%%%%%
%%%%P%.%.%.%%.%
%%...%%...%%..%
%%%%..%%.%%.%%%
%..%.%%..%..%.%
%%%..%%%%.%%..%
%...%.%.%%.%..%
%%.%%%%.%%%.%%%
%%.%.%.%%.%%%%%
%....%...%.%%.%
%.%%%%....%.%%%
%..%%..%...%..%
%...%.%%.%%.%.%
%.%..%.%...%..%
%%%%%%%%%%%%%%%
