%%%%%%%%%%
%%%P..%..%
%.%.%%%%.%
%...%....%
%....%%..%
%%%.%.%.%%
%...%....%
%.%...%..%
%.%.%....%
%%%%%%%%%%
