%%%%%%%%%%%%%%%
%P...%%......%%
%.%.%.%%.%%%%.%
%.%.%..%%%%%..%
%.%%%%%..%.%..%
%%.%.%%%%.%..%%
%.%%%%%%%.%%%.%
%.%%.%.%......%
%%%.%%%%..%.%.%
%%.%.%.%%.%%..%
%.%.%.%.%..%.%%
%%%%%.%%%.%%%.%
%.%.%.%.%%.%%%%
%.%.%...%.%..%%
%%%%%%%%%%%%%%%
