%%%%%%%%%%%
%P....%..%%
%%.%..%...%
%.....%%.%%
%........%%
%%.%.%...%%
%%%..%.%..%
%....%%.%.%
%.....%...%
%.........%
%%%%%%%%%%%
