%%%%%%%%%%
%P..%..%%%
%.%%%%%..%
%..%%..%%%
%%.%%..%%%
%%.%%%...%
%%.%.%%%.%
%%%%%%.%.%
%..%.%...%
%%%%%%%%%%
