%%%%%%%%%%%%%%%%%%%%
%P%..%%.......%.%..%
%.%.%.....%.%%..%%.%
%...%%...%..%%...%.%
%.%..%%%..%%%......%
%.%.%..%%..%%%%..%.%
%.%.%%.%.%%....%%.%%
%...%%%%%%.%....%.%%
%.%.%%%%%..%.%%..%%%
%%%%%%%...%%.%.%%.%%
%...%%.....%%.%%.%.%
%%%...%%......%%.%.%
%.%%%%%%%%%.%%%%%%%%
%..%%%...%%%%.%%...%
%....%..%%...%.%.%%%
%%.%.%.%.%..%%.%%.%%
%..%%%%%.%%.....%..%
%%..%%......%.....%%
%.%.%..%%..%.....%.%
%%%%%%%%%%%%%%%%%%%%
