%%%%%%%%%%
%P......%%
%.%%%....%
%..%.%%%%%
%.%......%
%.%.%.%%.%
%.%.%....%
%.%.%%..%%
%....%...%
%%%%%%%%%%
