%%%%%%%%%%
%%P.....%%
%.....%..%
%.%%.%%%%%
%...%%.%.%
%.%%%%...%
%......%.%
%....%...%
%..%....%%
%%%%%%%%%%
