%%%%%%%%%%%
%P..%.%.%.%
%.%.%.%..%%
%.......%.%
%.%..%....%
%...%....%%
%..%...%.%%
%...%.%%%%%
%%.%%.%.%.%
%..%.%%%%.%
%%%%%%%%%%%
