%%%%%%%%%%%%%%%%%%%%
%P.%.%........%....%
%....%%..%%.%%.%%%.%
%.%%%%..%.....%...%%
%......%%%%%%.%%.%.%
%.%.%%..%...%..%%.%%
%.%..%.%%%%.%.%%.%.%
%.%%.%%%..%.%%%.%%%%
%..%.%.%%%.%.%..%..%
%.%.%.%.%...%..%.%.%
%.%%%.%.%.%%..%.%%.%
%.%.%...%%%.%%%.%..%
%..%..%%..%.%..%.%%%
%%%.%%.%%....%..%..%
%.%.%.%.%%.%.%%%.%%%
%.%..%.%..%.%..%%%.%
%.%%%.%..%.%%.%....%
%%...%..%%%%.%%%%%%%
%..%...%.%.%.%.....%
%%%%%%%%%%%%%%%%%%%%
