%%%%%%%%%%%
%P.%%%..%.%
%.%..%%.%.%
%.........%
%..%..%.%.%
%%.%%%....%
%..%.%.%.%%
%....%....%
%..%.%..%%%
%.%.......%
%%%%%%%%%%%
