%%%%%%%%%%%%%%%
%P%%%..%.%.%..%
%.%%..%...%%..%
%%...%%%.%%.%%%
%...%%%..%..%.%
%%%....%%.%...%
%%.%%%...%.%..%
%..%..%%%%%.%%%
%.%%%...%%%...%
%..%.%.%%.%%%%%
%.%..%.%.%.%..%
%%.%%.%..%....%
%...%%%%..%..%%
%%%..%...%..%.%
%%%%%%%%%%%%%%%
