%%%%%%%%%%%%%%%
%P%%...%.%..%%%
%%%.%.%.%%.%..%
%%..%%%.%.%%%.%
%........%.%.%%
%.%.%%%%%..%%.%
%.%%%%%..%%%%%%
%%..%..%%.%..%%
%.%.%%.%.%%.%.%
%...%.%%%..%.%%
%.%.%%.%%%...%%
%%.%%%.%.%%%%%%
%...%.%...%...%
%.%..%......%.%
%%%%%%%%%%%%%%%
