%%%%%%%%%%
%P.%%%...%
%%%%%.%.%%
%....%...%
%.%....%%%
%.%%%%...%
%.%%.%%%.%
%.%.%%..%%
%..%.%.%.%
%%%%%%%%%%
