%%%%%%%%%%
%P.......%
%.%.%.%%.%
%.%.%.%..%
%.....%%.%
%.%.%%%..%
%...%.%%%%
%.%.%....%
%.....%.%%
%%%%%%%%%%
