%%%%%%%%%%%%%%%%%%%%
%P.%...%%....%..%..%
%%.%%%.%...%..%..%.%
%.......%...%.%.%.%%
%.%.%%%..%..%%%...%%
%%%%%.%%%...%.%%%..%
%.%%.%%%%%%..%%.%.%%
%..%..%..%%%%%%%...%
%....%..%..%..%%.%.%
%.%%.%..%%.%%%%...%%
%..%%.%.%%%%..%%%.%%
%%..%.%%.%%.%%..%.%%
%%%..%%...%%...%%.%%
%.%.%.%.%....%.....%
%.%.%.%...%%%....%.%
%..%.%%..%%%%.%.%..%
%.%.%...%.%.%.%%%.%%
%%.%%%.%%%%%....%.%%
%.%.%..%%%..%..%%..%
%%%%%%%%%%%%%%%%%%%%
