%%%%%%%%%%%%%%%
%P......%.....%
%....%..%.%%..%
%%%%...%%.%%%.%
%.%.%....%%...%
%.%.%.%%%..%%%%
%......%%.%...%
%.%%%..%%...%%%
%%.%.%..%%%%%.%
%....%%%%...%.%
%.%.%.%.%.%...%
%%%%.%..%%..%.%
%%%.%%%.%%%%%.%
%.%%...%.%%%.%%
%%%%%%%%%%%%%%%
