%%%%%%%%%%%%%%%
%P....%.......%
%.%%%%%.%.%.%.%
%...%..%.%%%%%%
%%%.%.%%%..%.%%
%.%%.%.%..%%%.%
%..%%%%%%%.%..%
%.......%.%...%
%.%.%.%...%.%%%
%..%%%%.%.%%%.%
%%%..%.%...%%%%
%...%%%.%.%.%.%
%.%%%.%%%.%...%
%...%....%%.%.%
%%%%%%%%%%%%%%%
