%%%%%%%%%%
%P....%..%
%..%%.%..%
%...%%...%
%.%.%.%%%%
%..%..%.%%
%...%%%..%
%.%%%%.%.%
%...%%%.%%
%%%%%%%%%%
