%%%%%%%%%%%%%%%
%P..%%%.....%.%
%..%.%%.%%.%.%%
%%......%%...%%
%..%%..%%%%%.%%
%..%.......%..%
%%%..%%%.%..%.%
%..%.%.%%%.%%.%
%%..%.%.%.%...%
%....%%%.%.%.%%
%%%.......%%.%%
%.%%.%%.%.%.%.%
%.%.%%%%.%%%%.%
%%%...%.%..%..%
%%%%%%%%%%%%%%%
