%%%%%%%%%%%
%P.....%..%
%.%%%.%%.%%
%.%...%%..%
%.%..%%.%.%
%%......%.%
%.%%%.%..%%
%.%.%.%%.%%
%.%.%%%.%.%
%.%%...%..%
%%%%%%%%%%%
