%%%%%%%%%%%%%%%%%%%%
%P.%..........%...%%
%....%%..%%.%%.%%..%
%.%%%%..%.....%.%%%%
%......%%.%%%.%%.%.%
%.%.%%..%...%..%%..%
%.%..%.%%%%.%.%%.%.%
%.%%.%.%..%.%%%.%%%%
%....%.%%%.%.%...%.%
%.%.%.%...%.%..%.%.%
%.....%.%.%...%.%%.%
%.%.%.%.%%..%%%.%..%
%..%..%%..%%%..%.%%%
%%%.%%..%.......%..%
%.%.%.%.%%.%.%%%..%%
%.%.%%.%.%%.%..%%%.%
%.%%%.%..%.%%.%....%
%%..%%%.%%%%..%%%%.%
%..%.%.%.%...%..%..%
%%%%%%%%%%%%%%%%%%%%
