%%%%%%%%%%%
%P.%......%
%..%%..%..%
%...%.%%..%
%.%%%.%%.%%
%....%%%..%
%%%.....%.%
%...%.%%..%
%.%%..%..%%
%.........%
%%%%%%%%%%%
