%%%%%%%%%%%%%%%
%P.%..........%
%.%%%%.%.%..%.%
%.%%.%%%.%%%..%
%......%.%.%.%%
%.%%.%.%.%....%
%.%...%%.%.%.%%
%%%.%..%.%..%.%
%.%.%%%%%.%%%.%
%..%%%...%.%..%
%.%..%.%.%..%%%
%.%...%.%.%%..%
%.%%%%%.%.%%.%%
%.%..%.....%..%
%%%%%%%%%%%%%%%
