%%%%%%%%%%%%%%%%%%%%
%P.................%
%%%.%%.%%%.%%.%%.%.%
%.%..%.......%%..%%%
%.%%...%.%..%%%.%.%%
%....%.%.%%%%..%...%
%.%%.%......%.%%%%.%
%......%%%.........%
%.%....%.%.%.%%.%%.%
%.%..%........%%%..%
%.%%.%.%%.%.%....%.%
%%%...%.%.%.%%.%...%
%...%%...%.....%.%.%
%.%.%..%.%%%.%%%..%%
%....%%..%..%%...%%%
%.%%.%..%.%.%..%%%.%
%......%.....%..%%.%
%.%%%.%%%%.........%
%...%......%.%...%.%
%%%%%%%%%%%%%%%%%%%%
