%%%%%%%%%%
%P%....%.%
%.%....%.%
%.%..%...%
%...%..%.%
%..%.....%
%%...%...%
%%.%.%.%.%
%..%.%.%.%
%%%%%%%%%%
