%%%%%%%%%%%
%P.%....%.%
%.%.%%%.%%%
%%..%%%...%
%...%...%%%
%...%%%%%.%
%.%%.%.%.%%
%%..%....%%
%.%.%%..%%%
%......%..%
%%%%%%%%%%%
