%%%%%%%%%%%
%%%P..%.%.%
%.%...%%%.%
%.%%....%%%
%.%...%%%.%
%.........%
%%%%%%%%..%
%%..%..%%.%
%....%%%%%%
%...%...%.%
%%%%%%%%%%%
