%%%%%%%%%%%%%%%%%%%%
%P%..%%%......%%%..%
%%%.%.....%.%%%..%.%
%...%%...%..%..%%%%%
%.%..%%%..%%%%.%%.%%
%.%%%%.%%..%..%%...%
%.%..%.%.%..%..%%.%%
%...%%%%%%.%.%%%%%.%
%.%.%%.%..%%%.%%.%.%
%%%.%%%...%%.%%..%.%
%%...%.....%..%%%%%%
%%..%..%.%....%%.%.%
%%%.%%%.%%%%%.%%%%%%
%..%%%%....%..%%...%
%%%.......%..%.%.%%%
%..%%%.%.%..%%.%%.%%
%%.%%%.%.%%%....%%.%
%%..%....%..%....%%%
%.%..%.%.%.......%.%
%%%%%%%%%%%%%%%%%%%%
