%%%%%%%%%%%%%%%%%%%%
%P.%%......%...%.%%%
%..%.%%%%.%%%.%%%..%
%.%%%........%%%%.%%
%%%.%.%%..%%%%.%..%%
%...%.%%%%..%.%...%%
%.%...%..%.%..%%%.%%
%...%.%%%..%%.%....%
%.%%%%%%.%.%%%%%.%.%
%.%..%%%.%.%%%..%%.%
%.%...%..%.%.%.%%%%%
%...%.%%.%.%%%.....%
%.%%.%%.%.%..%...%.%
%.%%..%.%.%....%.%.%
%.%.%..%%%.%%%%.%%.%
%.%.....%.%%.%%..%.%
%%%%%.%....%...%.%.%
%.%.%.%...%...%.%%.%
%......%%...%%%....%
%%%%%%%%%%%%%%%%%%%%
