%%%%%%%%%%%%%%%%%%%%
%P%%....%.%...%%.%%%
%.%%%%.%%.%%%%.%..%%
%.%%%.%......%.%...%
%%....%%%..%%%%%%%%%
%..%.%%.%.%%.%.%%.%%
%.%..%%.%..%..%%%%.%
%%%%%%.%%.%..%%....%
%..%..%.%.%%..%%.%%%
%%.%.%.%%.%%.%%.%..%
%.%...%.%%.%..%.%.%%
%.%%..%%..%%..%.%%.%
%%..%.%.%%%...%..%.%
%.%.%.%%%%..%.%%.%.%
%.%....%.%%.%%.%%%.%
%...%%....%.%.%..%%%
%%%....%.%.%%%.%%..%
%%%.%...%.....%%%%%%
%..%..%.%...%......%
%%%%%%%%%%%%%%%%%%%%
