%%%%%%%%%%%%%%%
%P.%..........%
%.%%%%.%.%..%.%
%.%%.%%%.%%%..%
%........%.%.%%
%.%%%%.%.%%...%
%.%.%.%%.%.%.%%
%%%.%..%.%..%.%
%.%.%%%%%.%%%.%
%..%%%...%.%..%
%.%..%.%.%..%%%
%.%...%.%.%%..%
%.%%.%%.%.%%.%%
%.%..%.....%..%
%%%%%%%%%%%%%%%
