%%%%%%%%%%%%%%%%%%%%
%P................%%
%..................%
%.%.%....%.........%
%..%.......%...%...%
%...%%....%...%....%
%%...........%.....%
%.......%...%.%....%
%%.....%..%...%....%
%%...%.......%%....%
%.......%%.........%
%%...........%..%.%%
%%.%.......%....%..%
%...%......%.......%
%......%...........%
%........%.%.%.....%
%.................%%
%.%%...%.....%.%...%
%..................%
%%%%%%%%%%%%%%%%%%%%
