%%%%%%%%%%%%%%%%%%%%
%P%%.%%%%...%.%.%.%%
%..%.%.%.%%.%.%%.%.%
%%%%...%%..%..%%.%.%
%..%.....%...%.....%
%%%%%%.%..%..%.%%%.%
%......%...%%.%.%%.%
%....%%%%.%%.%...%.%
%..%.%%%%%..%%..%..%
%%..%.%......%%.%%%%
%%%.%...%..%%%...%%%
%..%%...%.%%.%%%..%%
%%.%.%..%..%.%.%.%%%
%..%.%...%.%%....%%%
%...%%%%.%.....%.%%%
%..%.%...%%.%%%%%.%%
%..%%..%%..%%..%%%.%
%%%.%%%%.%..%%%.%.%%
%.%...%.%%.%%.%.%%.%
%%%%%%%%%%%%%%%%%%%%
