%%%%%%%%%%
%P.%%.%..%
%.......%%
%%%%.%...%
%.%%.%.%.%
%.%%..%..%
%..%.....%
%.%..%%%.%
%....%%%.%
%%%%%%%%%%
