%%%%%%%%%%
%P.%%.%..%
%.......%%
%%.%%..%.%
%..%.%%..%
%.%%..%%.%
%..%.%...%
%%...%%%%%
%...%.%.%%
%%%%%%%%%%
