%%%%%%%%%%%%%%%%%%%%
%%P.%.%%...%..%%%..%
%......%%%%.%%%....%
%.%%.%%.%.%.%%..%%.%
%.....%%..%.%%..%.%%
%%%%..%%.%..%..%...%
%.%%%...%..%%..%%.%%
%%%%%..%%%.%.%%%%%%%
%.%.%%%..%..%.%..%.%
%..%.%%......%.%%.%%
%.%.%.%%.%..%..%%.%%
%%.%%..%%......%.%.%
%.%%.%%..%.%%%%.%.%%
%..%%%%..%%%.%...%.%
%%%.%...%....%%%.%.%
%.%%%%%...%%.%..%%%%
%%.%%..%.%.%%...%.%%
%%..%.....%..%%..%%%
%.%.%..%%....%%.%..%
%%%%%%%%%%%%%%%%%%%%
