%%%%%%%%%%%%%%%%%%%%
%P.%....%...%.%....%
%%%%%.......%..%%.%%
%.%.%%%.%%%..%.....%
%...%.%%%%.%.%..%%.%
%.%%....%.%%%..%.%.%
%%..%..%.%%%..%%..%%
%.%....%%.%...%...%%
%...%%..%..%.%%.%%.%
%%%.%.%%..%.%%.%%%%%
%.%%....%.%%..%....%
%.%.%.%.%..%%%.%%.%%
%%.%...%%.%.%.%....%
%%...%%%..%...%.%.%%
%.%%.%.%%%%.%.%.%..%
%.%...%.%.%%%.%..%.%
%%%%%%.%%%..%.%%.%.%
%.%%...%...%.%.%%%.%
%%%.%.%.%.%..%%....%
%%%%%%%%%%%%%%%%%%%%
