%%%%%%%%%%%%%%%%%%%%
%P.................%
%%%.%%..%%.%%.%%.%.%
%.%..%..%.....%..%%%
%.%%...%%%%.%%%.%.%%
%....%.%...%%..%...%
%.%.%%......%.%%%%.%
%.......%%.........%
%.%..%.%.%.%.%%.%%.%
%.%..%.....%.%%%...%
%.%%%%.%.%%.%....%.%
%.%..%..%%%.%%%%...%
%...%%...%.....%.%.%
%.%.%..%.%.%%%.%...%
%....%%......%...%%%
%.%%.%..%.%%%..%%%.%
%......%..%%.%..%%.%
%.%%%.%%%%%....%...%
%...%........%...%.%
%%%%%%%%%%%%%%%%%%%%
