%%%%%%%%%%%
%P........%
%.%%.%%%%.%
%..%%%....%
%..%...%%.%
%.%%.%.%.%%
%.%.......%
%.%.%%.%%.%
%...%..%.%%
%.%..%....%
%%%%%%%%%%%
