%%%%%%%%%%%%%%%%%%%%
%P%.%%%%%.%%.%..%..%
%.%.%.%...%%.%%%%%.%
%.%.%%%%%%%..%..%..%
%.%.%..%.%%%.%.%%%%%
%...%..%.%..%.%..%%%
%.%.%..........%%..%
%%..%.%%%%.%.%%%..%%
%%%%...%.%..%%.%%..%
%......%%%...%...%%%
%%...%.%%.%%%.%%..%%
%..%%%%%%.%.%%.%%..%
%.%.%.%%.%.%..%.%%.%
%..%..%.%.%..%%.%.%%
%.%%%%...%...%..%%%%
%.%%.%.%%..%.%%%%%%%
%.%.%.%%.%%....%%%.%
%..%.%%%%..%%.%....%
%%..%%.......%.%.%%%
%%%%%%%%%%%%%%%%%%%%
