%%%%%%%%%%%%%%%%%%%%
%%%%%P..%..%.%..%%.%
%..%..%.%.%....%.%%%
%.%%.%%%.%..%.%..%.%
%.%%%%..%%%%%%%%.%%%
%........%...%.%.%%%
%%%.%.%.%%....%%...%
%...%%%.%..%%%.%.%.%
%...%.%%.%%.%..%..%%
%.%%%%%......%.%%..%
%%%%......%.%....%%%
%.%%%.%..%%%%.%.%%.%
%%%...%..%%%....%%.%
%.%.%.%.%.%.%%.%%.%%
%%%.%%.%%%%%%%%%%..%
%%..%.%..%%.%.%%%..%
%..%.%%%%..%%%%...%%
%%..%.%.%%%.%..%.%%%
%%.%...%%....%.%..%%
%%%%%%%%%%%%%%%%%%%%
