%%%%%%%%%%%
%P.....%..%
%.%.%.%%..%
%..%..%%..%
%..%%....%%
%%..%%.%%.%
%..%......%
%.........%
%..%%%.%.%%
%..%......%
%%%%%%%%%%%
