%%%%%%%%%%
%P.......%
%..%.%.%%%
%.%%.%...%
%.%....%.%
%.%.%%.%.%
%...%....%
%.%...%%.%
%...%....%
%%%%%%%%%%
