%%%%%%%%%%
%%P%%%.%.%
%...%..%.%
%.%......%
%%%.%%%%.%
%%....%..%
%.%...%..%
%....%%%%%
%%%%....%%
%%%%%%%%%%
