%%%%%%%%%%%%%%%
%P............%
%.%%.%%%%%..%.%
%..........%%.%
%.%.%%%.%%%%..%
%.......%..%%.%
%.%%..%.%.%.%.%
%..%..%.....%.%
%.%%%...%.%%..%
%..%.%%.%%%..%%
%%..........%.%
%..%.%.%%.%...%
%.%%%...%..%.%%
%.%...%...%...%
%%%%%%%%%%%%%%%
