%%%%%%%%%%%%%%%
%P.%..........%
%.%%%%.%.%..%.%
%.%..%%%.%%%..%
%.%....%.%.%.%%
%.%%.%.%.%....%
%.%....%.%.%.%%
%%%.%..%%%..%.%
%.%.%%%%%.%%%%%
%..%%%...%.%..%
%.%..%.%.%..%%%
%.%...%%.%%...%
%.%%%%%.%..%.%%
%.%..%.%.%....%
%%%%%%%%%%%%%%%
