%%%%%%%%%%
%P.......%
%%.%.....%
%...%%%%.%
%..%%%...%
%.%%..%%%%
%..%%.%.%%
%..%.....%
%.....%.%%
%%%%%%%%%%
