%%%%%%%%%%%
%P.....%..%
%.%%.%.%%.%
%%.%%.....%
%.%%.%%%%%%
%.%..%.%..%
%.%%%%.%%.%
%..%.%%...%
%%%%%%%.%.%
%.........%
%%%%%%%%%%%
