%%%%%%%%%%%%%%%%%%%%
%P...%.............%
%%%.%%.%%%.%%.%%.%.%
%.%..%..%....%...%%%
%.%%...%%.%.%%%.%.%%
%.%.%%.%.%.%...%...%
%.%.........%.%%%%.%
%...%..%%%..%......%
%.%...%%.%.%.%%.%%.%
%.%..%........%...%%
%.%..%.%.%%.%....%.%
%...%%%.%%%...%%...%
%...%%...%.....%.%.%
%.%.%..%.%.%..%%...%
%....%%......%...%%%
%.%%.%..%.%%...%...%
%......%..%..%..%%.%
%.%%%.%%.%%%...%...%
%...%........%...%.%
%%%%%%%%%%%%%%%%%%%%
