%%%%%%%%%%%%%%%
%P%%%...%%....%
%.%.....%.%%..%
%%.%..%..%%..%%
%...%%%%%%..%.%
%.%.....%.%%..%
%...%.%....%..%
%..%%%%%%.%.%%%
%%%%%%..%%%...%
%..%%..%%.%%%%%
%.%%%..%.%%%..%
%%.%%.%%.%....%
%..%%.%%..%..%%
%.%..%......%.%
%%%%%%%%%%%%%%%
