%%%%%%%%%%
%%P.....%%
%...%%...%
%.%...%%%%
%......%.%
%%%.%....%
%.%.%%.%.%
%....%.%.%
%.......%%
%%%%%%%%%%
