%%%%%%%%%%
%%P%%%...%
%...%..%.%
%.%......%
%%%.%%%%.%
%......%.%
%.%......%
%.....%%%%
%%.%....%%
%%%%%%%%%%
