%%%%%%%%%%
%P.......%
%.%%%%.%.%
%.%%.%...%
%.%%....%%
%.%%%%%%%%
%...%...%%
%.%...%.%%
%...%....%
%%%%%%%%%%
