%%%%%%%%%%%%%%%%%%%%
%P...........%..%..%
%%.%%%.%..%.%.%..%.%
%.......%...%%%.%.%%
%.%.%..%%%..%%%....%
%%%%%.%....%%.%%%.%%
%....%%%%%%..%%.%.%%
%..%..%..%%%%%%....%
%....%..%..%.%%%.%.%
%.%%.%%.%..%.%%...%%
%.%%%.%%%..%...%%%%%
%%..%%%%.%%%%%..%.%%
%.%..%%.%.%%....%..%
%.%...%.....%%....%%
%..%%%%...%%%...%%.%
%..%.%%.%%%%%%%.%..%
%%%.%..%%.%...%%..%%
%..%..%%.%%.......%%
%...%.%..%..%..%%.%%
%%%%%%%%%%%%%%%%%%%%
