%%%%%%%%%%%%%%%%%%%%
%P.%.......%.......%
%%%%%.%...%.%.%%...%
%.%.%.%.%.%%.%%..%.%
%...%.%%%%.%...%.%.%
%..%....%.%.%.%%%.%%
%%%.%..%..%%%.%.%%.%
%.%....%..%......%%%
%..%%....%..%.%.%%.%
%%%%.%.%.%%%%%%%..%%
%.%%.%..%%%....%.%.%
%.%.%%.....%..%%.%.%
%..%...%%.%.%.%..%.%
%.%.%.%%..%.....%%%%
%.%....%.%%.%.%.%..%
%....%%%%..%..%..%.%
%%%.%..%...%%....%.%
%..%.%.%.%.%.%%%%%.%
%.%.%..%%.%..%%....%
%%%%%%%%%%%%%%%%%%%%
