%%%%%%%%%%%%%%%%%%%%
%P%.%.%.....%...%..%
%.%.%.%%%.%.%.%%..%%
%.%.%..%.%.%..%..%%%
%%%%...%%.%.%..%%.%%
%....%..%.%.%.%%...%
%.%...%%%%%.%..%..%%
%%..%.%%..%..%%....%
%%.%%.%....%%%.%.%%%
%%%%.%.%%%.%%%%%...%
%..%%%.%%..%%%...%%%
%...%%....%..%.%.%%%
%.%.%%.%.%.%..%.%%%%
%.%%%.%.%.%%%%.%%%.%
%%..%.%.%.......%%.%
%%%.....%.%.%.%%...%
%..%.%%%%%%.%%..%%.%
%%.%%%%%...%....%.%%
%...%.%..%....%%%%.%
%%%%%%%%%%%%%%%%%%%%
