%%%%%%%%%%%%%%%
%P............%
%.%%.%.%.%%%%.%
%.%%.%.%%...%%%
%.%......%%...%
%...%.%.%...%%%
%.%.%.....%...%
%...%%%.%.%%%.%
%.%.........%.%
%..%%%%%.%%.%.%
%.%.......%.%.%
%...%.%%%.%.%.%
%.%..%.....%%.%
%..%...%.%....%
%%%%%%%%%%%%%%%
