%%%%%%%%%%%%%%%%%%%%
%P.........%%...%..%
%%.%%..%%%....%%%%.%
%%...%%..%%..%..%..%
%..%...%..%%%%%....%
%%%%%..%.%.......%.%
%.%.%.%%...%.%%%...%
%.......%.%...%..%.%
%.%.%..%..%...%%...%
%...%%..%..%...%..%%
%%%%%%.%.%...%....%%
%%%......%...%..%.%%
%...%%%.%.%.....%%.%
%%.%%.......%%%....%
%....%%%.%%%...%%.%%
%%%%.%.....%.%...%.%
%%%%..%%%......%...%
%....%..%.%....%..%%
%.%..%%...%.%..%..%%
%%%%%%%%%%%%%%%%%%%%
