%%%%%%%%%%
%P...%..%%
%.%%..%..%
%...%%%.%%
%.%......%
%...%%%%.%
%.%.%....%
%...%%%.%%
%%%..%...%
%%%%%%%%%%
