%%%%%%%%%%%%%%%%%%%%
%P..%.%%.%....%....%
%%%%%%...%%.%.%%...%
%%%.....%.%.....%%%%
%...%%%...%..%%%%..%
%%...%.%%.%%..%...%%
%..%%%...%.....%.%%%
%.%.....%.%%%.%..%.%
%%%....%%%%.%...%%%%
%.%.%.%.......%.%..%
%.%%..%%%%.%%%.%%%.%
%..%.%%.%.%%.%..%.%%
%..%...%....%%%.%..%
%..%.%%..%.%..%%%%%%
%%%.%%..%.%%%.%%...%
%.%..%%%%.%%.%..%%.%
%%..%%.%%%.%.%..%%.%
%%..%%%%%%%%...%%%%%
%.%....%.%....%%.%.%
%%%%%%%%%%%%%%%%%%%%
