%%%%%%%%%%%
%P........%
%..%%%%..%%
%.%%.%..%.%
%.%%...%..%
%....%.%%%%
%%%..%..%%%
%.%%.%..%.%
%....%%%.%%
%.%.......%
%%%%%%%%%%%
