%%%%%%%%%%%
%P..%.%..%%
%.%.%.%%%%%
%...%.%.%.%
%.%%%%....%
%%%.%....%%
%..%...%.%%
%...%.%%%%%
%%.%%.%.%.%
%.%%%.%%%.%
%%%%%%%%%%%
