%%%%%%%%%%%%%%%
%P............%
%.%%.%.%.%%%%.%
%.%%.%%%....%.%
%.%......%%..%%
%.%.%.%%%.%.%.%
%.%.....%.....%
%...%%%.%.%%%.%
%.%%%.........%
%.%.%%%%%.%.%.%
%.%..%..%.%.%.%
%...%.%.%.%...%
%.%........%%.%
%..%.%.%.%....%
%%%%%%%%%%%%%%%
