%%%%%%%%%%%%%%%%%%%%
%%%%%P..%..%..%.%.%%
%..%..%.%.%.%.%%...%
%.%%.%%%.%...%%..%.%
%.%%%..%%%%%..%.%.%%
%........%..%%.%%%%%
%%%.%.%.%%....%%%%.%
%...%%%.%..%.%.%.%.%
%...%.%%%.%.%...%..%
%..%%%.%.%%..%.%...%
%%.....%%...%....%%%
%.%.%%.%.%.%%.%.%%.%
%.%.%..%%..%....%%.%
%.%%%%%%%%..%%.%%.%%
%...%%%%%...%%%%%..%
%%...%..%..%%.%%%..%
%....%..%.%.%%%....%
%..%...%%%..%..%.%%%
%.%.%%...%%..%.%..%%
%%%%%%%%%%%%%%%%%%%%
