%%%%%%%%%%%
%P........%
%.%.%%.%%%%
%.%%%.....%
%...%...%%%
%%..%..%%.%
%..%..%...%
%..%...%%.%
%%.%%..%..%
%.........%
%%%%%%%%%%%
