%%%%%%%%%%%%%%%%%%%%
%P%%....%....%..%%.%
%.%%%..%.....%%....%
%%.%%.%%.%%%%%...%%%
%.....%..%%%..%...%%
%.%..%.%.%.....%%..%
%.%%%..%%%.%%%%.%%%%
%..%.%%%.%%%..%%...%
%...%%.........%...%
%%%%.%..%.%.%..%%%%%
%%...%..%%...%..%%%%
%%.%.%%.%..%.....%.%
%%..%.%.%.%%%%%%.%.%
%%.%.%..%.%%...%..%%
%..%..%..%.%.%.%..%%
%....%%.%..%.%..%%.%
%.%%.%%..%%..%%%%.%%
%%%%.%%%.%%.%%%..%%%
%...%.....%%...%%.%%
%%%%%%%%%%%%%%%%%%%%
