%%%%%%%%%%%%%%%%%%%%
%%P.%.%%...%%.%....%
%.%.%..%%...%.%%%..%
%.%%.%%.%.%.%%%%%.%%
%.....%...%%%.%%..%%
%%%%..%%.%%.%%.%.%%%
%..%%..%%..%..%%..%%
%%%%%..%%%%%.%.%.%%%
%..%%%%..%..%.%..%.%
%..%..%.....%%.%%.%%
%%%.%..%%......%%.%%
%.%%%%%.%%...%.%.%.%
%..%....%..%%.%.%.%%
%..%%%%.%%%%.%%..%.%
%..%.%%%%....%.%.%.%
%..%.%%.%%%%.%..%%.%
%.%.%.%..%.%....%.%%
%.%.%..%.%%%.%%..%.%
%..%%%.%%%%..%..%.%%
%%%%%%%%%%%%%%%%%%%%
