%%%%%%%%%%%%%%%%%%%%
%%%P..%%%.......%%.%
%.%.%......%%%%....%
%%...%%%%.%.%%...%%%
%%.%....%%%...%.%.%%
%..%.%..%%.%...%%..%
%..%.%%..%.%%%%.%%%%
%%.%..%..%%...%%...%
%.%%%%...%.%%..%...%
%.%%.%.%%%..%%.%.%%%
%....%.%.%...%..%%%%
%%.%.%%%.%.%%..%.%.%
%%..%.%.%.%%%%..%.%%
%..%.%..%%%..%%..%.%
%..%%.%..%%%.%%..%%%
%....%%.%.%%..%.%%%%
%..%.%%...%...%..%.%
%%%%.%%%..%.%.%..%%%
%.........%%.%.%...%
%%%%%%%%%%%%%%%%%%%%
