%%%%%%%%%%
%%P..%..%%
%...%..%.%
%.%.%%%%%%
%.%%%.%%.%
%%%...%.%%
%.%%%.%..%
%.%%..%..%
%.%..%%.%%
%%%%%%%%%%
