%%%%%%%%%%%%%%%
%P............%
%.%%.%%%%%..%.%
%.....%....%..%
%.%%%%%%%.%...%
%.......%%..%.%
%%.%.%%.%.%...%
%.....%...%.%.%
%.%.%...%..%..%
%..%.%%.%%%..%%
%%.%........%.%
%..%.%.%%%%...%
%.%.%...%..%.%%
%.%...%...%...%
%%%%%%%%%%%%%%%
