%%%%%%%%%%%%%%%
%P...%.%.%....%
%.%%%..%%..%%%%
%..%%..%..%%..%
%...%%..%%...%%
%.%%%.%.%.%.%%%
%.%.%.%..%.%%.%
%.%%.%%%%%....%
%.........%%%.%
%.%.%%%%.%..%%%
%.%%.%%.%.%%..%
%..%%..%%%.%.%%
%.%.%%%...%%%.%
%..%....%...%.%
%%%%%%%%%%%%%%%
