%%%%%%%%%%%%%%%%%%%%
%%%%P.%.%.%.....%..%
%.%.%...%.%%.%%%.%.%
%%%.%%%%.%.......%.%
%..%%%..%..%.%.%.%.%
%...%%.%.%%...%...%%
%.%....%%.%.%.%%%.%%
%%.%%.%%%.....%%.%.%
%%%%...%.%%..%.%%%.%
%...%.%..%....%%.%.%
%.%..%..%.%.%.%%%.%%
%..%.%%%%.....%%.%.%
%.%...%..%%%.%.%%%.%
%.%..%%%%.%%%%%.%.%%
%...%%....%..%%%%.%%
%%%.%%.%%%.%.%%%%%%%
%..%%.%%.%...%%%%%.%
%..%..%.%%.%%...%..%
%%.%.%.%.....%...%.%
%%%%%%%%%%%%%%%%%%%%
