%%%%%%%%%%%%%%%%%%%%
%P...%..%....%%..%%%
%%..%%.%%..%....%%.%
%..%%.%..%...%.%%%.%
%..%....%..%..%%.%%%
%%.%.%..%%..%%%.%%.%
%.%%%%...%%%.%%.%..%
%....%.%%%.%%%%.%.%%
%%...%%..%..%..%%..%
%%.%%......%%%.%.%%%
%.%%%...%%%%.%..%%%%
%.%%%%%%.%......%..%
%.%%%.%....%.%..%%.%
%%.%.%.%%%.%..%.%..%
%......%....%%.%%%.%
%%.%....%.%%.......%
%......%.%..%%%..%%%
%%.%%.....%...%%%%.%
%%.%%%..%....%.%.%.%
%%%%%%%%%%%%%%%%%%%%
