%%%%%%%%%%
%P.%.%...%
%.%....%%%
%.%.%%...%
%.%.%..%%%
%.%..%.%%%
%...%...%%
%%%..%...%
%%.....%.%
%%%%%%%%%%
