%%%%%%%%%%%%%%%
%P..%.%.%.%...%
%..%%..%%%%.%.%
%%%......%%..%%
%%..%%%%..%...%
%.%...%...%%..%
%%%%...%.%..%.%
%..%.%%....%%.%
%....%....%..%%
%.%.%%.%.%%%.%%
%%%%.%...%.%..%
%...%%..%.%..%%
%%%.%%%..%.%%.%
%%..%..%%...%%%
%%%%%%%%%%%%%%%
