%%%%%%%%%%%%%%%
%P%...........%
%...%%.%%%%%%%%
%.%......%.%.%%
%....%.%%...%%%
%.%%%.%%.%.%%.%
%%.%..%%%.%%%%%
%.%%.%%..%.%..%
%..%.%..%%%.%.%
%...%..%%...%.%
%...%%.%.%.%%.%
%.%.%%%.%%.%.%%
%%.%.%%.%.%..%%
%%......%...%.%
%%%%%%%%%%%%%%%
