%%%%%%%%%%%%%%%
%%P.....%.%%%.%
%..%.%%..%%.%.%
%%%%%%%....%%.%
%...%%..%...%.%
%%.%%..%.%%%..%
%.....%%.%..%%%
%.%%%.%%%.%%..%
%%%%.....%%%.%%
%%%%%%%..%....%
%.%..%.%%...%.%
%.....%..%%.%%%
%..%..%%%%%%%.%
%.%....%.%..%.%
%%%%%%%%%%%%%%%
