%%%%%%%%%%%
%P.....%%%%
%.%..%....%
%...%..%..%
%...%%.%%%%
%%..%..%..%
%....%.%%.%
%....%....%
%.%.....%%%
%..%..%...%
%%%%%%%%%%%
