%%%%%%%%%%%
%P..%.%..%%
%.%.%.%%%%%
%%..%.%.%.%
%%%%%%....%
%%%.%..%..%
%....%..%.%
%.%%.....%%
%.%.......%
%.%%.%.%%%%
%%%%%%%%%%%
