%%%%%%%%%%%%%%%%%%%%
%P..%....%.....%...%
%.%..%..%.%..%%...%%
%%%%..%%%%%.%..%.%.%
%.%......%....%%.%.%
%%%.%%%.%%..%..%%%.%
%.%%%.%..%.%%%%.%%.%
%.%...%%%%..%%.%..%%
%..%%...%%%...%...%%
%.%.%%%%%.....%%%.%%
%..%.%..%....%%%...%
%%%....%..%%.%.%%%%%
%.%.%.%.%%%.%%%%%%.%
%.%..%.....%%%..%.%%
%%.%%.%...%..%%%%..%
%%%%.....%%.%.%.%..%
%.%%.%%%%.%.%%..%.%%
%%.%%.........%.%.%%
%.%.%.%%..%..%%%.%.%
%%%%%%%%%%%%%%%%%%%%
