%%%%%%%%%%%
%P........%
%.%..%.%.%%
%..%..%%%.%
%%.%......%
%..%.%%%%.%
%%....%..%%
%...%..%..%
%..%%.%%.%%
%%%%%.....%
%%%%%%%%%%%
