%%%%%%%%%%%%%%%
%P.%%...%.....%
%..%....%.%%..%
%.%%%%.%%.%%%.%
%.%%%....%%.%.%
%%%.%.%%%..%%%%
%...%...%.%...%
%%%%...%%...%%%
%....%%%%.%.%.%
%.......%%%%..%
%.%.%%....%.%.%
%.%%.%%%%%...%%
%%%.%.%%.%..%%%
%..%....%%%%..%
%%%%%%%%%%%%%%%
