%%%%%%%%%%
%P%......%
%%..%%%%.%
%......%%%
%%%%.%.%.%
%%.%..%..%
%..%%...%%
%.%%%%%%%%
%%.%%%..%%
%%%%%%%%%%
