%%%%%%%%%%%%%%%
%P...%...%.%%.%
%.%.%%%%%..%%%%
%.%.%.%%.%%.%.%
%....%%....%%.%
%.%.%..%.%...%%
%.%...%%%%..%.%
%.%%%...%%%%.%%
%%...%.%%%%.%.%
%.%%.%%%%%.%%.%
%%.%.%%%.%..%.%
%.%..%....%.%.%
%.%%..%%.%%..%%
%..%...%%.%%..%
%%%%%%%%%%%%%%%
