%%%%%%%%%%%%%%%
%%%%P%.%.%.%..%
%%...%%...%%..%
%%%%..%%.%%.%%%
%..%..%..%..%.%
%.%%.%%%%.%%..%
%%.%.%%.%%.%..%
%..%..%.%%..%%%
%.%%%..%%.%%%%%
%..%.%%..%.%%.%
%%%.%%.%..%.%%%
%%.%%.%.%..%..%
%...%%%%%.%.%%%
%.%..%..%..%%.%
%%%%%%%%%%%%%%%
