%%%%%%%%%%%
%P%.......%
%.%%%%..%.%
%%.%.%%.%.%
%.........%
%.%%%.%%%.%
%%%...%.%%%
%.%%..%..%%
%%%.%..%.%%
%.%...%...%
%%%%%%%%%%%
