%%%%%%%%%%%%%%%
%P.%%%..%...%.%
%.%%...%.%.%%.%
%.%..%.%%..%..%
%....%...%...%%
%%%%..%%%.%%..%
%.%.%%.%.%%%%.%
%%%.......%%..%
%.%%...%%%%%.%%
%...%%.%......%
%.%%%%%%%%.%%.%
%.%%...%%.%%..%
%.%..%%...%.%%%
%......%%.%.%.%
%%%%%%%%%%%%%%%
