%%%%%%%%%%%
%P........%
%.%.%%%%%.%
%...%...%.%
%.%.%%%.%%%
%.........%
%.%%%.%%.%%
%..%...%..%
%%...%%%.%%
%..%.%....%
%%%%%%%%%%%
