%%%%%%%%%%%%%%%
%P.%..%..%.%%.%
%.%.%%%%...%.%%
%.%%%..%.%%%%%%
%.%...%%...%%.%
%.%.%..%%.%..%%
%.%...%%....%.%
%%%%%%...%%%..%
%....%.%.%..%.%
%.%...%%.%.%%.%
%.%%....%%..%%%
%.%%.%.%..%.%%%
%.%%..%%.%%..%%
%..%...%%.%%..%
%%%%%%%%%%%%%%%
