%%%%%%%%%%%%%%%
%P...........%%
%.%.%%%%%%.%..%
%.%.%.%..%..%.%
%%%%.%%%%%%.%.%
%.%.....%.%...%
%.%.%%%%%.%%%%%
%.%%..%.%.%.%.%
%%%.%.%.%%..%%%
%.%.%%%.%.%.%.%
%..%.%.%..%%%.%
%.%..%%..%..%.%
%.%%%.%%%.%.%%%
%.%.%.....%%%.%
%%%%%%%%%%%%%%%
