%%%%%%%%%%%%%%%%%%%%
%P.%..%.%...%%...%.%
%..%.%%%..%..%%%.%.%
%%..%.%%.%..%%..%%%%
%.%%%%.%%...%%..%..%
%........%.%%.%%.%.%
%.%.%.%.%.%.%%%.%%%%
%.%%%%..%.%%.%.%%%.%
%.%%.%..%%.%%%.%%%.%
%.%.%...%..%.%.%%..%
%.%%.%.%.%.%..%%.%.%
%%.%%..%.%%%.%%%.%%%
%.%.%%%...%%%.%...%%
%.%.%..%...%.%%%..%%
%..%%%%%%%...%%%%%.%
%.%.%.%%%%.%%..%%.%%
%%.%.%%.%%.%%%%%.%%%
%..%...%.%..%%..%%.%
%..%...%%.%..%..%..%
%%%%%%%%%%%%%%%%%%%%
