%%%%%%%%%%%%%%%
%%P......%..%.%
%..%%%%...%.%.%
%%%%%%.%.%..%%%
%...%%.%..%.%.%
%%.%...%..%.%.%
%....%%.%%.%%.%
%.%%%....%.%..%
%%%...%...%%..%
%%.%%....%....%
%%%%%...%%..%.%
%...%%...%..%%%
%%.%.%%%%%..%.%
%...%..%....%.%
%%%%%%%%%%%%%%%
