%%%%%%%%%%%
%P.%%%..%.%
%%%%.%..%%%
%%...%...%%
%...%..%.%%
%...%%%%%.%
%..%.%.%.%%
%...%....%%
%.%.%%..%%%
%..%...%..%
%%%%%%%%%%%
