%%%%%%%%%%%
%P........%
%%%%...%.%%
%...%.%...%
%.%..%.%.%%
%.%.......%
%.%.%..%%.%
%...%.%...%
%.%.......%
%..%%.%%..%
%%%%%%%%%%%
