%%%%%%%%%%%
%P.......%%
%.%%%%..%.%
%.%....%%%%
%....%%...%
%%%.%.%%%%%
%%%...%.%.%
%%..%.....%
%.%.%%.%..%
%.......%.%
%%%%%%%%%%%
