%%%%%%%%%%%%%%%%%%%%
%%P%.%%.%..%..%%%.%%
%..%....%.%.%..%...%
%.%..%%.%%...%%..%.%
%%%.%%%%.%%%..%.%.%%
%....%.%%%..%%.%.%%%
%.%.%%...%....%%%%.%
%..%%.%.%..%.%.%.%.%
%%%.%..%%%%.%..%%..%
%..%%%.%.%%..%.%...%
%%.....%%.%...%....%
%.%.%%.%.%.%.%.%%%%%
%.%.%..%%..%%%%.%.%%
%.%%%%%%%%..%...%%%%
%...%%%%%...%%%%.%%%
%%...%%.%%%%.%.....%
%....%..%.%.%..%..%%
%..%...%%%...%%.%..%
%.%.%%...%%.%.%%.%%%
%%%%%%%%%%%%%%%%%%%%
