%%%%%%%%%%
%P.......%
%.%.%%%%.%
%.%%%....%
%.%....%.%
%.%%.%.%.%
%........%
%.%%%%.%.%
%........%
%%%%%%%%%%
