%%%%%%%%%%%
%P........%
%%%..%.%..%
%.......%.%
%..%.%%%.%%
%........%%
%.%.%..%%.%
%...%.%...%
%.%.......%
%.%%%.%%..%
%%%%%%%%%%%
