%%%%%%%%%%%%%%%%%%%%
%P.................%
%.%%.%%.%.%%.%.%.%%%
%.%...%%...%.%..%..%
%.%.%....%.%....%.%%
%.%%%%%%%...%.%%..%%
%....%.%%%%%%.%.%%.%
%..%.%.......%.%%%.%
%%%..%%.%.%%.....%.%
%.%%%%.%....%%%%.%.%
%%%.%...%%%%...%%%.%
%..%%%.%%.%.%.%...%%
%.%%..%%.%....%%%..%
%....%%%.%%.%.%.%%.%
%.%.%..%...%%....%%%
%%%...%%%%%....%.%.%
%...%%.%.%.%.%%.%%%%
%%.%%%.%%..%.%%.%..%
%....%......%..%.%.%
%%%%%%%%%%%%%%%%%%%%
