%%%%%%%%%%
%P.%%....%
%...%..%%%
%%.%.%.%.%
%..%.%%..%
%.%%%%%..%
%..%.%.%.%
%..%%%%%.%
%....%%..%
%%%%%%%%%%
