%%%%%%%%%%
%P.......%
%.%.%.%%.%
%.%.%..%.%
%.%....%.%
%.%%%%%%.%
%.%......%
%.%.%%.%.%
%...%....%
%%%%%%%%%%
