%%%%%%%%%%%
%%P%%..%..%
%..%..%%%.%
%.%.%%.%..%
%.....%%.%%
%.%%..%.%%%
%.%...%...%
%..%.%%%..%
%..%.%.%%%%
%%.%.%....%
%%%%%%%%%%%
