%%%%%%%%%%
%P.......%
%%.%%.%.%%
%..%.....%
%.%%.%%%.%
%...%.%%.%
%%%%%..%.%
%%%...%%.%
%...%.%%.%
%%%%%%%%%%
