%%%%%%%%%%%%%%%
%P%..%%.%.%%.%%
%.%%.%......%.%
%..%%..%%%%...%
%%....%%%..%.%%
%..%%.%..%%%%%%
%%%%...%.%.%.%%
%%%....%%%%...%
%.%%.%.%.%.%..%
%.%%.%.%%.%%.%%
%...%%%%.%%.%%%
%.%..%.%.%....%
%..%%...%%%%%.%
%.%.%.%.%..%%.%
%%%%%%%%%%%%%%%
