%%%%%%%%%%
%P.%..%..%
%.%%%....%
%%.%%...%%
%.%%...%%%
%...%%%..%
%....%%.%%
%%%...%..%
%.%.%%...%
%%%%%%%%%%
