%%%%%%%%%%%%%%%
%P..%%%....%..%
%.........%%..%
%%%..........%%
%.%...%%%.%...%
%.%%%..%%.....%
%..%..%.%%.%%.%
%.%%%%%..%....%
%.%%..........%
%.......%....%%
%.%%..........%
%.......%%....%
%...........%.%
%..%....%..%..%
%%%%%%%%%%%%%%%
