%%%%%%%%%%%%%%%%%%%%
%P%...%.%..%.%..%..%
%.%.%%..%....%%%%%.%
%%..%%.%%%...%..%..%
%...%%..%.%%.%.%%%%%
%...%....%%.%.%....%
%.%.%%.%.%%.%..%%..%
%%.%%.%%%%...%%%%.%%
%%%%.%.%.%.%%%.%%..%
%........%..%%%..%%%
%.%..%%.%.%.%.%%%.%%
%.%%.%..%....%..%%.%
%.%.%.%%..%%.%%.%%.%
%..%..%.%.....%%..%%
%.%%%....%...%.%%.%%
%%%..%.%%.%%.%%%%%.%
%.%.%.%%.%%.....%%.%
%.%%.%..%%.%%......%
%%.%%%.......%.%.%%%
%%%%%%%%%%%%%%%%%%%%
