%%%%%%%%%%%
%P%%...%..%
%%.%..%%%.%
%.%%..%..%%
%.%%.%.%.%%
%...%%.%%.%
%.%..%%..%%
%.........%
%%.%%.%..%%
%%%.%%..%.%
%%%%%%%%%%%
