%%%%%%%%%%
%P..%.%..%
%......%.%
%%..%%%..%
%%.%.%%%%%
%......%.%
%.%%.....%
%....%.%.%
%%.%%....%
%%%%%%%%%%
