%%%%%%%%%%%%%%%%%%%%
%P%.....%.%%.....%.%
%%%...%.%%.%%.%%.%.%
%.%.%....%.%...%..%%
%.%.%..%...%%..%%..%
%.%%%.%%%.%%.%..%%.%
%..%%....%..%%..%..%
%.%%....%...%%..%.%%
%.%%%%..%..%..%%.%.%
%%.%...%...%.%%%.%%%
%...%%..%..%%%..%%%%
%%%%%.....%%%%%%.%.%
%...%%%.%%%.%%..%.%%
%%%%.%.%..%..%....%%
%%.%%.%%.%%%.%%.%..%
%.%%.%%.%.%.%..%..%%
%.....%%%%%%%.%%...%
%..%%....%%%%%..%%%%
%.%.%.%...%.%..%...%
%%%%%%%%%%%%%%%%%%%%
