%%%%%%%%%%%%%%%%%%%%
%P.%.%....%.%.%....%
%....%%.%%%.%..%.%.%
%.%%%%..%.....%...%%
%......%%.%%%.%%.%.%
%.%.%%..%...%..%%..%
%.%..%.%%%%.%.%%.%.%
%.%%.%%%..%.%%%.%%%%
%....%.%%%.%.%..%..%
%.%.%...%.%.%.%%.%.%
%...%%%.%...%..%..%%
%.%.%....%%.%.%.%..%
%..%..%%..%.%..%.%%%
%%%.%%.%%....%..%..%
%.%.%.%..%.%.%%%.%%%
%.%..%..%.%.%..%%%.%
%.%%%.%..%.%%.%....%
%%%..%%.%%%%.%%%%%%%
%..%.....%.%.%.....%
%%%%%%%%%%%%%%%%%%%%
