%%%%%%%%%%
%P.%.%..%%
%%.....%%%
%..%%%%.%%
%..%.....%
%.%..%%%%%
%%...%..%%
%........%
%%%.%....%
%%%%%%%%%%
