%%%%%%%%%%%%%%%%%%%%
%P.%%......%%..%...%
%%.%.%%%%...%.%%.%.%
%..%%.%..%.%.%%%...%
%%%.%.%%%.%.%.%%...%
%...%.%%%.%%.%.%..%%
%.%...%..%%.%%%..%.%
%...%.%%.%%..%.%%..%
%.%%%%%%.%.%.%.%%%.%
%.%..%%%.%%%%.%..%%%
%.%%...%.%....%.%..%
%%%%%%......%..%.%%%
%.%.%.%%.%%..%...%.%
%.%.%...%.%...%%.%.%
%...%%.%%..%%%%.%%.%
%.%%%.%%.%%%.%%..%.%
%......%%%.%...%.%%%
%%.%.%%..%%...%.%%.%
%.%%..%%.%..%%%....%
%%%%%%%%%%%%%%%%%%%%
