%%%%%%%%%%%%%%%
%P.%........%.%
%.%%%%.%.%..%.%
%....%.%.%%...%
%.%......%.%.%%
%.%%.%.%.%....%
%.%...%%.%.%.%%
%%%.%..%%%..%.%
%.%.%.%%%.%.%%%
%..%%.%..%.%..%
%.%.%%.%.%..%%%
%.%...%%.%%%..%
%..%%.%.%..%.%%
%.%..%.%.%....%
%%%%%%%%%%%%%%%
