%%%%%%%%%%
%P%%.%...%
%.%....%%%
%.%%%%...%
%....%.%.%
%........%
%....%.%%%
%%%.%.%%.%
%%.......%
%%%%%%%%%%
