%%%%%%%%%%%%%%%
%P.....%....%.%
%..%..%%%%..%%%
%.%%%...%.%.%.%
%.%.%%%.%.%%.%%
%.%%%%....%.%%%
%.%.%.%%.%..%%%
%%%.%%..%%.%%.%
%.%%.%%%%.%.%.%
%.%%.%%%..%%%%%
%.%%.%......%%%
%....%.%...%%%%
%%.%%..%%..%..%
%%..%%%.%%..%.%
%%%%%%%%%%%%%%%
