%%%%%%%%%%%
%P.....%%.%
%%%..%%.%.%
%.%.%%....%
%..%%...%.%
%%.....%%.%
%.%%..%%.%%
%%....%..%%
%.%%%.%.%%%
%%........%
%%%%%%%%%%%
