%%%%%%%%%%%%%%%
%P............%
%.%%.%.%.%%.%.%
%.%%.%.%....%%%
%.%......%%...%
%...%.%%%%..%%%
%.%.......%%..%
%...%%%.%%.%%.%
%.%.........%.%
%.%.%%%%%%%.%.%
%.%....%..%.%.%
%...%%%.%.%.%.%
%.%..%.....%%.%
%..%...%.%....%
%%%%%%%%%%%%%%%
