%%%%%%%%%%
%%%P..%%.%
%%..%....%
%%.%%%..%%
%..%...%.%
%...%....%
%...%...%%
%%%...%..%
%...%%...%
%%%%%%%%%%
