%%%%%%%%%%%
%P..%.....%
%.%....%%.%
%.%%%.%.%.%
%...%...%.%
%.%%%%.%..%
%.%.....%.%
%%%%..%.%.%
%.%%.%%..%%
%..%%.%...%
%%%%%%%%%%%
