%%%%%%%%%%%%%%%%%%%%
%P..%......%.....%.%
%%%%..%.....%.%%.%.%
%.%.%.%.%.%%.%%.%..%
%%..%.%%%%.%%....%.%
%%%%..%.%.%.%.%%..%%
%...%.%....%.%.%...%
%.%......%.%...%.%.%
%.%.%....%...%..%%.%
%.%..%.%.%..%.%.%%.%
%.%%.%..%%%.....%..%
%.%.%.%%%.%.%%%%%.%%
%......%...%.%..%..%
%%..%.%....%....%.%%
%.%%...%%.%.%.%..%.%
%...%%%%..%%..%.%%.%
%.%%.%...%.%%..%%%.%
%.%%%.%%..%%.%.%%%.%
%...%..%.%%...%.%..%
%%%%%%%%%%%%%%%%%%%%
