%%%%%%%%%%%
%P.%......%
%...%.%.%.%
%%.%.%..%%%
%....%.%..%
%.%%.%.%%.%
%.%..%..%%%
%.%%%%..%.%
%%%.%%%%%%%
%.%.%.....%
%%%%%%%%%%%
