%%%%%%%%%%
%P....%.%%
%.%.%...%%
%..%%.%.%%
%.%.%.%.%%
%.%..%%%.%
%.%%.%.%.%
%........%
%.%%.%%..%
%%%%%%%%%%
