%%%%%%%%%%%%%%%%%%%%
%P...%...%..%%%..%.%
%%..%%.%%%..%.%%%..%
%.%%%%.%..%.%.%%%%.%
%%.%...%...%%.%..%.%
%..%.%..%%%.%.%.%%.%
%.%%%%%..%%%.%%..%%%
%..%.%.%%...%%%%%.%%
%%...%%.%%.%%.%%...%
%...%.......%.%%...%
%.%%%%..%%%..%.%%%%%
%.%..%...%...%..%%.%
%....%.%...%.%.....%
%.%%%.%%%..%.%..%..%
%%.%%.%%....%%.%%%%%
%.%.%..%%.%%..%..%.%
%.......%%..%%%..%.%
%%..%..%..%.%.%%.%.%
%.%%.%.%.%.%.%.%...%
%%%%%%%%%%%%%%%%%%%%
