%%%%%%%%%%%%%%%%%%%%
%P...........%.....%
%.%%.%%.%%%%.%.%.%%%
%.%...%%...%.%%.%%.%
%.%.%....%.%.......%
%.%%%%%%%...%%%%..%%
%....%.%%%%%%.%.%.%%
%..%.%.......%.%%%.%
%%%..%%.%.%%.%...%.%
%.%%%%.%....%%%%.%.%
%%%.%...%%%%...%%%.%
%..%%%.%%.%.%.%...%%
%.%%..%%.%....%%%..%
%.%..%%%.%%.%.%.%%.%
%.%.%..%...%%....%%%
%.%...%%%%%....%%%.%
%...%%.%.%.%.%%.%%%%
%%.%%..%%..%.%%.%..%
%....%......%.%%.%.%
%%%%%%%%%%%%%%%%%%%%
