%%%%%%%%%%%%%%%%%%%%
%P.%..........%....%
%....%%..%%.%%.%%%.%
%.%%%%..%.....%..%%%
%......%%%%.%.%%.%.%
%.%%%%..%...%..%%.%%
%.%..%.%%%%.%.%%.%.%
%.%%.%%%..%%%%%.%%%%
%....%.%.%.%.%.....%
%.%.%.%.%%%.%..%.%.%
%.%.%.%.%...%.%.%.%%
%.%.%..%.%..%.%.%..%
%..%..%%..%%%..%.%%%
%%%%%%.%%....%..%..%
%...%.%..%.%.%%%..%%
%.%..%.%..%.%..%%%.%
%.%%%.%..%.%%.%....%
%%..%%.%%%%%..%%%%%%
%..%...%.%...%.....%
%%%%%%%%%%%%%%%%%%%%
