%%%%%%%%%%%
%P%.......%
%......%.%%
%....%....%
%.%.....%.%
%.%.%%%.%.%
%......%%.%
%...%...%.%
%.%...%.%.%
%..%%..%%%%
%%%%%%%%%%%
