%%%%%%%%%%%
%P...%..%.%
%.%..%%..%%
%.......%.%
%%%.%%....%
%........%%
%.%%%%.%..%
%.%.%%.%%.%
%.%.%%%.%.%
%.........%
%%%%%%%%%%%
