%%%%%%%%%%
%P.......%
%.%.%%%%.%
%.%.%...%%
%.....%..%
%.%.%%%%%%
%.....%..%
%.%.%.%%.%
%...%....%
%%%%%%%%%%
