%%%%%%%%%%%
%P.......%%
%.%.%.%%..%
%.%%%%%%%.%
%.........%
%%..%..%..%
%..%.%%%.%%
%%....%...%
%...%.%..%%
%..%%%....%
%%%%%%%%%%%
