%%%%%%%%%%%
%P........%
%%.%%%%.%%%
%.%.%%%.%.%
%...%.%.%%%
%....%%...%
%.%%%%.%%%%
%%..%..%%.%
%.%.%%%.%%%
%.........%
%%%%%%%%%%%
