%%%%%%%%%%
%P....%..%
%.%%%.%%.%
%%.%%...%%
%...%.%%.%
%%...%%..%
%.%..%..%%
%.%.%...%%
%...%%.%%%
%%%%%%%%%%
