%%%%%%%%%%%%%%%
%P.%.%...%....%
%%...%%%.%.%%%%
%..%%.%%...%..%
%..%%..%%..%%.%
%..%%%.%....%%%
%.%..%.%%.%...%
%...%%.....%%.%
%.%....%.%%%%%%
%......%%.%.%.%
%..%%%.%.%%%%.%
%%%..%.%%..%.%%
%.........%%.%%
%.%..%.%..%..%%
%%%%%%%%%%%%%%%
