%%%%%%%%%%%%%%%
%P.%.%.%.%.%..%
%%%%%%.%.%%%.%%
%.....%.%%%%.%%
%%.%...%.%%%%.%
%.%.%.%%...%..%
%.%..%%%..%%..%
%.........%...%
%.%..%.%...%.%%
%.%....%%%..%.%
%%.%%..%%..%%%%
%%.%....%.%%%.%
%..%.%%%%%%%.%%
%.%....%%.%.%%%
%%%%%%%%%%%%%%%
