%%%%%%%%%%%
%P..%...%.%
%%%..%%...%
%.%%.%%..%%
%.%...%..%%
%.%%%%%.%.%
%.%..%....%
%%%%%..%%.%
%..%..%%.%%
%...%.....%
%%%%%%%%%%%
