%%%%%%%%%%%%%%%%%%%%
%P.%....%%..%..%...%
%..%.%%%.%.%%.%..%.%
%.%%%%...%.%..%%.%%%
%%.%%.%%.%.%.%...%.%
%.%%%%%%%%%.%%..%..%
%%%....%.%%%%.%%.%.%
%%.%%.%%.%%..%%.%..%
%%%.%%.%.%.%%.%%..%%
%.%.%%...%......%..%
%..%%.%.%.%%...%.%.%
%%%%...%%...%.%%%%%%
%..%%.%%...%.....%.%
%%..%....%.%%.%.%..%
%.%%.%%%..%.%%..%%.%
%%..%%.%...%%%%%%..%
%....%...%.......%.%
%.%.%.%......%%.%%.%
%%.%%.%%%%%...%...%%
%%%%%%%%%%%%%%%%%%%%
