%%%%%%%%%%%
%P........%
%.%%%%.%%.%
%........%%
%.%%%%.%..%
%.%..%.%%.%
%.%%.%....%
%....%%%%.%
%.%%....%%%
%...%.%...%
%%%%%%%%%%%
