%%%%%%%%%%%
%P........%
%..%%.%%%.%
%.%.%.%.%.%
%%%.%%....%
%%.%%%%.%.%
%.....%...%
%.%%%...%.%
%..%..%%%%%
%%%.%%.%..%
%%%%%%%%%%%
