%%%%%%%%%%%%%%%
%P....%....%..%
%..%..%%..%...%
%%....%...%.%%%
%...%.%%.%%...%
%.%....%..%.%%%
%..%.%.%%....%%
%%......%%.%..%
%...%%..%..%%.%
%%.%..%...%..%%
%......%.%..%.%
%%%.%.%%...%%.%
%....%.%......%
%..%.....%...%%
%%%%%%%%%%%%%%%
