%%%%%%%%%%%
%P....%..%%
%%....%...%
%....%%%..%
%........%%
%%...%.%.%%
%%%..%.%..%
%.%.%%%...%
%.....%...%
%.....%...%
%%%%%%%%%%%
