%%%%%%%%%%%
%P%..%%...%
%%%.%.%%.%%
%.%...%%%%%
%%%%.%%%.%%
%...%%.%%.%
%%%..%%..%%
%.........%
%%.%%.%..%%
%%%.%%..%.%
%%%%%%%%%%%
