%%%%%%%%%%%%%%%
%P..%%%..%%%..%
%........%%.%.%
%.%.......%...%
%.%...%%%..%..%
%.%%%.%%%.....%
%..%....%%.%%.%
%.%%%%%..%....%
%.%%..........%
%...%...%....%%
%%..%%........%
%.......%%....%
%.%......%..%.%
%%%%%%..%..%..%
%%%%%%%%%%%%%%%
