%%%%%%%%%%
%P%...%.%%
%.%..%%..%
%...%.%..%
%.%%..%..%
%.....%..%
%...%%%..%
%.%...%.%%
%.%.....%%
%%%%%%%%%%
