%%%%%%%%%%
%P.......%
%..%..%%%%
%%...%.%.%
%.%.%..%%%
%.%.%%.%.%
%...%%%%.%
%......%%%
%.%.%.%..%
%%%%%%%%%%
