%%%%%%%%%%%
%P........%
%.%%%%%%%.%
%....%...%%
%.%%.%.%..%
%.%..%%%%.%
%.%%.%....%
%....%%.%%%
%.%%....%.%
%...%.%...%
%%%%%%%%%%%
