%%%%%%%%%%%%%%%%%%%%
%P...%......%.....%%
%%.%%%.%%%.%.%%%.%.%
%.%%%%...%%..%.%%..%
%%.%...%....%.%%.%%%
%.%%....%%%.%%%%.%%%
%.%%%....%%%.%%.%%%%
%..%.%.%%..%...%.%%%
%%...%%..%..%.%.%.%%
%%.....%.%.%%%%.%..%
%.%%.%%..%%%%%..%%%%
%.%.%%.%.%%%%%%.%%.%
%%%%..%..%.%.....%.%
%%.%.%%%..%...%.%..%
%.%.%%%%.%..%%.%.%%%
%%.%...%%%%%%%.....%
%..%%%%.%%%.%.%.%%.%
%.%%%%.%.%..%.%%.%.%
%%...%.%%..%.%...%.%
%%%%%%%%%%%%%%%%%%%%
