%%%%%%%%%%
%P.......%
%.%%%%%.%%
%...%%...%
%%%.%.%..%
%...%%%.%%
%.%%.%%..%
%....%.%%%
%....%...%
%%%%%%%%%%
