%%%%%%%%%%%
%P.%%%..%.%
%.%.%...%.%
%....%%...%
%%...%%.%.%
%....%....%
%..%.%%...%
%..%......%
%..%.%..%%%
%.%...%...%
%%%%%%%%%%%
