%%%%%%%%%%%%%%%
%P....%..%.%%.%
%......%...%.%%
%.%%%.%%.%%%%.%
%.%.%..%%..%%.%
%%%.%%%%%.%..%%
%.%%...%....%.%
%.%%%....%%%..%
%..%%%.%.%..%.%
%.%...%.%..%..%
%.%%.....%%.%.%
%.%%.%.%%.%..%%
%.%%..%%%%%%.%%
%..%%...%...%.%
%%%%%%%%%%%%%%%
