%%%%%%%%%%%
%P..%..%..%
%.%....%%.%
%.%%...%%.%
%...%...%.%
%.%%%%.%..%
%.%.....%.%
%%%%%.%.%.%
%.%..%%..%%
%...%.....%
%%%%%%%%%%%
