%%%%%%%%%%%%%%%%%%%%
%%%P.%.%%...%.%...%%
%%%.%..%%.%...%%%..%
%....%%...%.%%%.%.%%
%.%%..%%%.%%%..%%.%%
%.%.%%%%%%..%%.%%%%%
%...%..%...%%.%%%..%
%...%.%%%%%%%%.%..%%
%%.%.%%%...%%%.%%%.%
%.%.%.%...%%.%%..%.%
%.%%%...%.%%%.....%%
%%..%%.%.%%.%%...%.%
%........%.%%.%%%%%%
%.%%%%%.%%%%%......%
%..%.%%.%....%.%%%%%
%%.%.%.%%%..%%%.%..%
%.%...%..%%%%..%...%
%...%..%.%%.%.%%%%%%
%..%%%.%%....%.%...%
%%%%%%%%%%%%%%%%%%%%
