%%%%%%%%%%
%P.......%
%.%%%%%%%%
%.%.%...%%
%.....%..%
%.%.%%%%%%
%.....%..%
%.%.%%%%.%
%........%
%%%%%%%%%%
