%%%%%%%%%%%%%%%%%%%%
%P.%...%.......%%..%
%%.%%%%%...%%.%%.%.%
%.......%...%.%.%.%%
%.%.%...%%..%%%..%.%
%%%%%.%%%..%%..%%..%
%.%%.%%%%%%..%%.%.%%
%..%%.%..%%%%%%....%
%....%.%..%..%%%...%
%...%%%%%%..%%.%..%%
%.%%%.%...%%%%.%%..%
%%.%%.%%.%....%%%.%%
%.%..%%..%%%...%%..%
%.%.%.%.%%...%.....%
%...%%%.%.%%%....%.%
%..%.%%.%%%%%.%.%..%
%.%.%..%%.%...%%%.%%
%..%%..%%.%%.%..%.%%
%.%.%..%%...%..%%..%
%%%%%%%%%%%%%%%%%%%%
