%%%%%%%%%%%
%P....%..%%
%%....%...%
%.....%%..%
%........%%
%%...%.%.%%
%%%..%.%..%
%.%..%%.%.%
%.....%...%
%.........%
%%%%%%%%%%%
