%%%%%%%%%%
%P.......%
%%..%%%%.%
%.%.....%%
%.%%%.%..%
%........%
%...%%%%.%
%.%..%...%
%......%.%
%%%%%%%%%%
