%%%%%%%%%%%
%P......%.%
%.%.%.%.%.%
%.%..%....%
%..%.%%.%%%
%.%%%.....%
%...%..%.%%
%..%...%..%
%..%.%.%%%%
%.%.......%
%%%%%%%%%%%
