%%%%%%%%%%%%%%%%%%%%
%P.%...%.%....%%.%%%
%%%%%..%.%.%%%%..%.%
%%.%..%%%.%%.....%%%
%%%.%%%...%%.%.%.%.%
%....%...%......%.%%
%%%.%%.%%%.%..%%..%%
%....%.%.%%.%%...%%%
%.%%%%....%..%..%..%
%%.%....%..%%..%.%.%
%...%..%.%...%%%.%%%
%.%%%...........%%%%
%%%%...%..%..%.%%..%
%.%.%...%.%%..%...%%
%..%%.%.%%%..%..%%.%
%.%%%%....%..%%%%%.%
%%%....%%....%%..%%%
%.%..%..%.%.%.%.%..%
%%%%..%%%.%%..%%%%.%
%%%%%%%%%%%%%%%%%%%%
