%%%%%%%%%%%%%%%%%%%%
%P%%....%%...%..%..%
%.%%%..%%%...%%.%..%
%%.%%.%%.%..%%...%%%
%.....%..%%...%...%%
%.%..%.%.%%%...%%..%
%.%%%..%%.%%%%%.%%%%
%%.%.%%%.%....%%...%
%...%%.%.%.%.%%.%.%%
%.%%.%..%%..%.%%.%%%
%%..%%.%%%...%%.%%%%
%%.%.%%%%........%.%
%%..%.%.%.%..%%%.%.%
%..%.%..%.%%%..%..%%
%%.%%%%..%.%.%.%..%%
%..%.%%.%..%.%..%%.%
%..%.%%...%..%%%%.%%
%%%%.%%%%.%%%%%%%%%%
%...%.....%%...%%.%%
%%%%%%%%%%%%%%%%%%%%
