%%%%%%%%%%%%%%%%%%%%
%P.........%%...%..%
%%.%%..%%%....%%%%.%
%%...%%..%%..%..%..%
%..%...%..%.%%%....%
%%%%%..%.%.......%.%
%.%.%.%%...%.%%....%
%.......%.%...%..%.%
%.%.%.....%...%%...%
%...%%..%..%...%..%%
%%%..%.%.%...%....%%
%%%......%...%..%.%%
%...%%%.%.%.....%%.%
%%.%%%......%%%....%
%.....%%.%%%...%%.%%
%%%%.%.....%.%...%.%
%%%%..%%%......%...%
%....%..%.%....%..%%
%.%..%%...%.%..%..%%
%%%%%%%%%%%%%%%%%%%%
