%%%%%%%%%%%%%%%
%P.%...%......%
%.%%%%.%.%..%.%
%....%%%.%%...%
%.%......%.%.%%
%.%%.%.%.%....%
%.%....%.%.%.%%
%%%.%..%%%..%.%
%.%.%.%%%.%%%.%
%..%%.%..%.%..%
%.%.%%.%.%..%%%
%.%...%%.%%%..%
%..%%.%.%..%.%%
%.%..%.%.%....%
%%%%%%%%%%%%%%%
