%%%%%%%%%%
%P%...%..%
%.%.%.%.%%
%...%...%%
%...%%...%
%.....%%.%
%.%.%.%..%
%%%...%%.%
%.......%%
%%%%%%%%%%
