%%%%%%%%%%%
%P........%
%.%%.%.%%.%
%..%%%..%.%
%.%%...%%.%
%.%%.%.%.%%
%.........%
%.%.%%.%%.%
%...%..%.%%
%.%..%....%
%%%%%%%%%%%
