%%%%%%%%%%%
%P........%
%.%%...%%.%
%%%%%.....%
%.%.%%%%..%
%%...%.%..%
%.%%%%.%%.%
%..%.%....%
%%%%%%%.%.%
%.........%
%%%%%%%%%%%
