%%%%%%%%%%
%P%.....%%
%...%%.%%%
%...%%.%.%
%%....%%.%
%..%.....%
%.%...%..%
%.%.%%%%.%
%.%..%...%
%%%%%%%%%%
