%%%%%%%%%%%%%%%
%P......%%..%.%
%%..%.%%.%.%%.%
%.%....%%..%..%
%.%.%....%%%.%%
%..%%..%%..%..%
%....%%%.%%%%%%
%%.%..%%.%....%
%..%%....%%.%%%
%....%%%%%%%..%
%.%%.%....%%%.%
%.%%.%%%%%....%
%.%%.%.%...%..%
%..%.%%..%..%.%
%%%%%%%%%%%%%%%
