%%%%%%%%%%%%%%%
%%P%..%..%..%.%
%.....%%%..%.%%
%%%.%.%.%%%.%.%
%.%.%..%....%.%
%.%.%..%.%%%..%
%....%%%%%.%.%%
%.%%%%..%.%%.%%
%..%%%.%%%..%.%
%%%..%%%%%.%..%
%.%%.%%.%%%.%.%
%.%%%%.%%.%..%%
%.%%..%%%%%%..%
%..%.%.%%.....%
%%%%%%%%%%%%%%%
