%%%%%%%%%%%%%%%%%%%%
%P.................%
%%%.%%.%%%.%%.%%.%.%
%.%..%..%....%%..%%%
%.%%...%%.%.%%%.%.%%
%....%.%.%.%%..%...%
%.%%.%......%.%%%%.%
%......%%%.........%
%.%....%.%.%.%%%%%.%
%....%.........%...%
%.%%.%.%%.%.%.%..%.%
%%%...%.%.%.%%.%...%
%...%%...%.....%.%%%
%.%.%..%.%%%.%%%...%
%....%%......%...%%%
%.%%.%..%.%.%..%%%.%
%......%...%.%..%%.%
%.%%%.%%%%.%.......%
%...%........%...%.%
%%%%%%%%%%%%%%%%%%%%
