%%%%%%%%%%%%%%%
%P............%
%.%..%.%.%%%%.%
%.%%%%.%%...%.%
%.%......%%...%
%...%.%%%.%.%.%
%.%...........%
%...%%%.%.%%%.%
%.%%%.......%.%
%.%.%%%%%%%.%.%
%.%.........%.%
%...%%%.%%%%..%
%.%..%.....%%.%
%..%...%.%....%
%%%%%%%%%%%%%%%
