%%%%%%%%%%%%%%%%%%%%
%P...%...%.........%
%.%%.%%...%%.%.%.%%%
%.%...%%...%.%..%..%
%.%.%....%.%....%..%
%.%%%%%%%...%.%%..%%
%....%.%%%%%%.%.%%.%
%.%%.%.......%.%%%.%
%%%..%%.%.%%.....%.%
%.%%%%.%....%%%%.%.%
%%%.%...%%%%....%%.%
%..%%%.%%.%.%.%...%%
%.%%..%%.%....%%%.%%
%....%%%..%.%.%.%%.%
%.%.%..%...%%..%.%%%
%%%...%%%%%....%%%.%
%...%%.%.%.%.%%.%%%%
%%.%%%.%%..%%%%.%..%
%....%......%..%.%.%
%%%%%%%%%%%%%%%%%%%%
