%%%%%%%%%%%%%%%
%P..%%.....%..%
%.....%...%%..%
%%%....%.....%%
%.%.......%...%
%.%%%.%%......%
%..%....%%.%%.%
%....%%..%....%
%%...%........%
%.......%....%%
%.%%..%.......%
%.%.....%%....%
%....%...%..%.%
%..%....%..%..%
%%%%%%%%%%%%%%%
