%%%%%%%%%%%
%P%.......%
%.%%%%%..%%
%%...%..%.%
%..%...%%.%
%%%%.%%%%.%
%.%%.%%.%%%
%..%..%..%%
%..%%.%%%%%
%.%.......%
%%%%%%%%%%%
