%%%%%%%%%%%%%%%
%P.%.%.%%..%.%%
%%%%%%.%%%%%.%%
%......%.%.%..%
%..%....%.....%
%.%.%.%..%...%%
%.%..%.%..%%.%%
%%%%%.%.......%
%.%..%.%...%.%%
%.....%%%%..%.%
%.%%%..%%...%%%
%..%.%%.%.%%%.%
%..%%%%%%%%%.%%
%....%.%%.%.%%%
%%%%%%%%%%%%%%%
