%%%%%%%%%%%%%%%
%P..%....%%..%%
%......%%%.%..%
%%%.%%..%%%..%%
%...%.%...%%..%
%..%%%%..%%%..%
%.%.....%.....%
%.%%...%%....%%
%.%..%%.%%%.%%%
%.%.%%%%..%%.%%
%.%%%...%..%%.%
%...%...%%%%.%%
%..%..%.%..%..%
%%..%..%.%%%%.%
%%%%%%%%%%%%%%%
