%%%%%%%%%%
%P%....%.%
%.%....%.%
%.%..%...%
%...%..%.%
%..%.....%
%%.%.%...%
%%.%.%.%%%
%..%.%...%
%%%%%%%%%%
