%%%%%%%%%%%
%P..%%....%
%.%..%..%.%
%.%%..%.%.%
%...%...%.%
%.%%%%.%..%
%.%.....%.%
%.%%..%.%.%
%.%%.%%..%%
%%.%%.%...%
%%%%%%%%%%%
