%%%%%%%%%%
%P.......%
%.%.%.%%.%
%.%.%....%
%.%....%.%
%.%%%%.%.%
%......%.%
%.%.%%.%%%
%...%....%
%%%%%%%%%%
