%%%%%%%%%%%%%%%%%%%%
%P...........%.....%
%%%%.%%.%%%%.%.%.%%%
%.%...%%...%.%%.%%.%
%.%.%....%.%.......%
%.%%%%%%%...%%%%..%%
%....%.%%%%%%.%.%.%%
%..%.%.......%.%%%.%
%%%..%%.%.%%.%...%.%
%.%%.%%%....%%%%.%.%
%%%%....%%%%...%%%.%
%..%%%.%%.%.%.%...%%
%.%%..%%.%%...%%%..%
%.%..%%...%.%.%.%%.%
%.%.%..%...%%....%%%
%.%...%%%%%....%%%.%
%...%%.%.%.%.%%.%%%%
%%.%%..%%..%%%%.%..%
%....%....%.%..%.%.%
%%%%%%%%%%%%%%%%%%%%
