%%%%%%%%%%%
%P%.%.....%
%..%%.%%%.%
%...%.%%%%%
%..%%%%...%
%.%%..%..%%
%..%.%....%
%.%%%%%.%.%
%...%%..%.%
%%%.%...%.%
%%%%%%%%%%%
