%%%%%%%%%%%%%%%
%P%...%....%..%
%..%..%%%.%...%
%%....%...%.%%%
%...%.%%.%%...%
%.%....%..%.%.%
%..%.%.%%....%%
%%......%%.%..%
%...%%..%..%%.%
%%.%..%...%.%%%
%......%.%..%.%
%%%.%.%.....%.%
%....%.%......%
%..%.....%...%%
%%%%%%%%%%%%%%%
