%%%%%%%%%%%%%%%
%P..%.%.%.%%.%%
%%....%...%.%.%
%..%%%%.%%%...%
%.%%.%..%..%.%%
%....%.%.%%%%%%
%%%%%%%%.%.%.%%
%.%.%.%.%%%...%
%%%%..%..%.%..%
%.%%.%.%%%%%.%%
%...%%%%%%%%%%%
%.%..%.%.%.%.%%
%..%%...%.%%%%%
%.%.%.%.%%.%..%
%%%%%%%%%%%%%%%
