%%%%%%%%%%%%%%%
%P%%.%%.......%
%.%%.%.%.%%%%.%
%.%.%%%...%%.%%
%%.......%%.%.%
%.%%%%.%...%.%%
%.%.%...%%....%
%.%%.%.%%.%%.%%
%..%%.%%...%%.%
%%%%.%..%.%..%%
%..%%%%%.%%.%.%
%%%%..%.%.%%%.%
%.%%.%%.%....%%
%.....%.%.%.%.%
%%%%%%%%%%%%%%%
