%%%%%%%%%%
%P.......%
%.%%.%%%%%
%.%.....%%
%...%%...%
%.%....%.%
%.%%.%...%
%....%.%.%
%%.....%.%
%%%%%%%%%%
