%%%%%%%%%%%%%%%%%%%%
%P%%..%%.%...%....%%
%..%%......%...%%..%
%%%%%..%.%%%.%..%..%
%..%.....%.%%.%%%%%%
%%%%%..%%....%%.%%.%
%.%...%.%%%...%%%%.%
%.%%%%%..%....%%..%%
%....%%%.%..%%%..%.%
%%.%..%%%.%%.%.%%..%
%%..%..%%%..%%%%%.%%
%%%.%.%..%.%%.%%...%
%%%%%%%%.%.%...%%%.%
%.%%.%.%%.%..%..%.%%
%%.%.........%%%.%%%
%..%.%.%%.%..%%....%
%.%.%%.%%%.%..%%%.%%
%..%%.%......%.%%..%
%%.%.%..%..%..%%%%.%
%%%%%%%%%%%%%%%%%%%%
