%%%%%%%%%%%
%P......%.%
%%%.%%%...%
%...%.%.%.%
%.%...%.%.%
%...%.%%..%
%%%......%%
%.%%.%%%..%
%..%..%..%%
%%...%%...%
%%%%%%%%%%%
