%%%%%%%%%%%%%%%
%P..%..%..%.%.%
%..%%..%%%..%%%
%.%%%..%%%%.%.%
%...%%%.%.%%%.%
%.........%..%%
%....%%%%%...%%
%%%%%...%%%%%.%
%..%.%%%.%..%.%
%%.%.%%%%.%.%%%
%.%%%%.%...%.%%
%......%.%...%%
%%..%%%%%..%..%
%.%.%%..%%%.%.%
%%%%%%%%%%%%%%%
