%%%%%%%%%%%%%%%
%P......%..%..%
%%..%.%.%.%%.%%
%%..%%......%%%
%....%.%..%...%
%..%.%%%%..%%.%
%%%.%%.%.%%%.%%
%%%.%....%...%%
%%.%..%%%%%.%%%
%%%..%.%.%...%%
%%..%.%..%..%.%
%.%.%.%%.%%%%%%
%..%%.%%..%..%%
%%.....%%.%%.%%
%%%%%%%%%%%%%%%
