%%%%%%%%%%
%P...%..%%
%.%%..%..%
%....%%.%%
%.%......%
%...%%%%.%
%.%.%....%
%...%%%.%%
%%%..%...%
%%%%%%%%%%
