%%%%%%%%%%%%%%%%%%%%
%%P%..........%....%
%....%%..%%.%%.%%%.%
%.%%%%..%.....%...%%
%......%%.%.%.%%.%.%
%.%%%%..%...%..%%.%%
%.%..%.%%%%.%.%..%.%
%.%%.%%%..%%%%%.%%%%
%....%.%.%.%.%.....%
%.%.%.....%.%..%.%.%
%....%%.%.%.%.%.%.%%
%.%.%....%..%.%.%..%
%..%..%%.%%%%..%.%%%
%%%.%%.%%....%..%..%
%.%.%.%.%%.%.%%%..%%
%.%..%.%....%..%%%.%
%.%%%.%..%.%%.%....%
%%...%..%%%%..%%%%%%
%..%...%.%...%.....%
%%%%%%%%%%%%%%%%%%%%
