%%%%%%%%%%%
%P...%...%%
%.%%...%%.%
%%.%......%
%..%.%%%%%%
%.%..%.%..%
%.%%%%.%%.%
%..%.%%...%
%%%%%%%.%%%
%.%.......%
%%%%%%%%%%%
