%%%%%%%%%%%%%%%%%%%%
%P.%.......%.....%.%
%%%%%.%..%..%.%%.%%%
%.%%..%.%.%%.%%.%..%
%.....%%%%.%%%...%.%
%.%.%.%.....%.%%.%%%
%%..%%%.%..%.%.%...%
%...%...%%.%...%.%.%
%.%.%...%....%...%%%
%%%.%.%%....%...%.%%
%.%.%...%.%%..%...%%
%...%.%..%%..%.%.%.%
%..%...%.%.%%%.%...%
%%..%....%.%.%%.%.%%
%.%%...%%%%.%...%..%
%...%%%%.%.......%.%
%%%%.%..%..%%.%%.%%%
%.%%%.%%..%%.%.%%%.%
%...%..%%.%.%.%..%%%
%%%%%%%%%%%%%%%%%%%%
