%%%%%%%%%%%
%P%.......%
%.%%%%.%.%%
%..%..%%..%
%.%..%%.%%%
%.%%..%%%.%
%..%%.%.%%%
%.%.%%%..%%
%.....%%%%%
%%.%%%....%
%%%%%%%%%%%
