%%%%%%%%%%%
%P........%
%.%%.%.%%.%
%..%%%....%
%......%%.%
%.%%.%.%.%%
%.........%
%.%.%%.%%.%
%...%..%.%%
%.%..%....%
%%%%%%%%%%%
