%%%%%%%%%%%%%%%%%%%%
%P............%....%
%%%.%%.%%%.%.%.%.%.%
%.%..%..%.........%%
%.%%...%%.%.%%%.%%%%
%..%.%.%.%.%.......%
%.%%.%......%.%.%%%%
%......%%%.%....%%.%
%.%..%.%.%.%%%%%%%.%
%...............%..%
%.%%.%.%%%%.%.%..%.%
%.%..%%.%%%.%%%%...%
%...%%...%.....%.%%%
%.%%%..%.%.%.%%%...%
%....%.......%...%%%
%.%%.%.%%%%.%..%%%.%
%.%......%%%.%..%%.%
%.%.%.%%.%%%.......%
%...%........%...%.%
%%%%%%%%%%%%%%%%%%%%
