%%%%%%%%%%
%P.......%
%.%.%%%%.%
%.%%%..%.%
%....%.%.%
%.%%.%.%.%
%.%..%...%
%.%.%%.%.%
%.%......%
%%%%%%%%%%
