%%%%%%%%%%%%%%%
%%P.....%...%.%
%..%.%%...%.%%%
%%%%%%%%.%..%.%
%....%.%..%...%
%..%..%...%.%.%
%%....%.%%.%%%%
%.%%%.%..%.%.%%
%%%......%%%.%%
%..%%%...%....%
%%%%..%.%...%.%
%%.%.%....%..%%
%%.%%%.%%%..%.%
%...%%%%.%..%.%
%%%%%%%%%%%%%%%
