%%%%%%%%%%%
%P........%
%.%%%.%.%.%
%...%.....%
%.%.%%%.%%%
%.........%
%.%%%.%%.%%
%..%...%..%
%%...%%%.%%
%..%.%....%
%%%%%%%%%%%
