%%%%%%%%%%%
%P........%
%.%%.%.%%.%
%..%%%.%..%
%..%.%.%%.%
%.%%.%.%.%%
%.........%
%.%.%%.%%.%
%...%..%.%%
%.%..%....%
%%%%%%%%%%%
