%%%%%%%%%%%%%%%
%P............%
%.%%.%%%%%%.%.%
%..........%%.%
%.%%%.%.%%%...%
%.....%.%.%.%.%
%.%%%.%.%.%...%
%.....%.....%.%
%%.%%...%.%%..%
%..%..%.%%%..%%
%%..........%.%
%..%.%.%..%...%
%.%%%...%..%.%%
%.%...%...%...%
%%%%%%%%%%%%%%%
