%%%%%%%%%%%%%%%%%%%%
%P....%....%.%..%..%
%%.%%%.%%..%.%...%.%
%..%...%%..%%..%%%%%
%.%.%%..%%..%%%..%%%
%%..%.%.%%.%.%.%..%%
%%%%....%%%.%.%.%..%
%..%.%....%%%..%.%%%
%....%........%%.%.%
%...%%%..%.%%%%...%%
%.%%..%%%..%.%.%%..%
%...%%..%.%..%%%%.%%
%.%..%%%%..%%%..%%.%
%%..%...%%%......%.%
%...%....%..%...%%%%
%%.%.%%%..%.%.%....%
%......%%%.%..%...%%
%.%..%.%.....%..%%%%
%.......%.%.%.%....%
%%%%%%%%%%%%%%%%%%%%
