%%%%%%%%%%
%P.%..%..%
%.%%%....%
%%.%%...%%
%..%..%%.%
%%.%.%...%
%...%..%%%
%%%....%%%
%...%%.%%%
%%%%%%%%%%
