%%%%%%%%%%%
%%P.%...%%%
%..%%.....%
%.%....%%.%
%.%%..%.%.%
%.%..%..%%%
%%%%.%%...%
%....%.%%.%
%.%%%%..%.%
%%%%.%.%..%
%%%%%%%%%%%
