%%%%%%%%%%%
%P...%....%
%%%...%%.%%
%.%%......%
%.....%...%
%.%.%%%.%.%
%.%%%%%%%.%
%..%...%%%%
%.%%.%%%..%
%.%.....%.%
%%%%%%%%%%%
