%%%%%%%%%%
%P%...%..%
%....%...%
%.%%.....%
%.....%%.%
%........%
%...%%%..%
%.%.%..%.%
%.%......%
%%%%%%%%%%
