%%%%%%%%%%%
%P....%..%%
%%.%..%...%
%.....%%..%
%%.......%%
%%...%.%.%%
%%%..%.%..%
%.%..%%...%
%.....%...%
%.....%...%
%%%%%%%%%%%
