%%%%%%%%%%%%%%%%%%%%
%%P%.......%.%.%...%
%.%%%%.%%%%.%.%...%%
%.%%%.%..%.%%.%%...%
%%%%%.%%%..%.%%...%%
%..%.%%.%%.%.%.%%%.%
%....%%.%%.%.%%%.%%%
%%%%%....%%.%%..%%.%
%..%.%%.......%%..%%
%%.%.%%.%.......%%%%
%..%..%.%.%%.%%%.%.%
%...%%........%%.%.%
%%%.....%.%.%.%..%.%
%....%%%.%..%.%%.%.%
%%%.%.......%.%.%%.%
%...%..%.%%..%..%.%%
%.%.%%%...%%%%%%%..%
%.%...%%%%....%%.%.%
%..%.%.%%...%.%....%
%%%%%%%%%%%%%%%%%%%%
