%%%%%%%%%%
%P.%.%...%
%%...%..%%
%..%..%..%
%..%%%%.%%
%.%...%%%%
%%..%%..%%
%.%%.....%
%...%....%
%%%%%%%%%%
