%%%%%%%%%%
%P....%..%
%.%%.%%.%%
%.%......%
%......%.%
%...%%%..%
%.%...%.%%
%..%%%%.%%
%..%%%...%
%%%%%%%%%%
