%%%%%%%%%%%%%%%%%%%%
%%P........%%...%..%
%%.%%..%%%....%%%%.%
%%..%%%..%%..%..%..%
%..%..%%.%%.%%%....%
%%%%%....%.......%.%
%.%.%%%%...%.%%....%
%.......%.%...%..%.%
%.%.%.....%...%%...%
%...%%%%%..%...%..%%
%%%..%%%.%...%.....%
%%%......%..%%..%.%%
%...%%%.%.%.....%%.%
%%.%%%......%%%....%
%.....%%.%%....%%.%%
%%%%.%.......%...%.%
%%%%..%%%....%.....%
%....%..%.%....%..%%
%.%..%%...%.%..%...%
%%%%%%%%%%%%%%%%%%%%
