%%%%%%%%%%%%%%%
%P%%%......%..%
%..%..%.%.%.%%%
%%..%%..%.%.%.%
%..%%%....%.%.%
%.%%%..%%.%.%%%
%.%...%%%.....%
%%%%......%..%%
%.%%..%%.%%%%%%
%%%%.%%%%.%%%%%
%%%.%...%%..%.%
%.%.%%...%%%.%%
%%.%..%.%..%..%
%%..%.%.%.%.%.%
%%%%%%%%%%%%%%%
