%%%%%%%%%%%%%%%
%P..%....%..%%%
%.....%%..%.%%%
%.%%%.%%%%%..%%
%...%%.....%.%%
%%%%%..%%%%...%
%.%.%....%.%%%%
%.%....%..%%..%
%.%..%%.%%.%..%
%.%%..%%.%%..%%
%...%.%....%.%%
%%%%%.%%%%.%%.%
%.%..%.%.%%%.%%
%....%%.%.%...%
%%%%%%%%%%%%%%%
