%%%%%%%%%%%%%%%%%%%%
%P%...%..........%%%
%%%.%.%.%%.%...%%%%%
%.%%%%..........%%.%
%.%...%..%%%%..%..%%
%.%..%%%.%%.%.%..%.%
%.%.%.%.%%%.%.%%...%
%%%.%.%%%%.%%%..%.%%
%.%.%......%...%%..%
%.%%.%%.%.%%..%.%..%
%%%%....%..%%..%..%%
%.%..%.%..%...%%.%.%
%....%%..%..%%.%%%%%
%%..%%.%%%.%%..%..%%
%.%%%.%.......%.%%.%
%.%.%.%%%%%.%%.%...%
%.%%.....%%...%%..%%
%%%%%%%.%%.....%%%%%
%.....%%.%.%%%..%%.%
%%%%%%%%%%%%%%%%%%%%
