%%%%%%%%%%
%P%%.%...%
%..%....%%
%.%..%%..%
%.%%%%%.%%
%.....%%%%
%%..%%..%%
%.%%.%..%%
%...%...%%
%%%%%%%%%%
