%%%%%%%%%%%%%%%%%%%%
%P.%...%...%.%..%.%%
%%.%%%.%...%.%...%.%
%.......%..%%..%%%%%
%.%.%%%.%%..%%%..%%%
%%%%%.%%%..%.%.%..%%
%.%%.%%%%%%.%.%.%.%%
%..%..%..%%%%....%%%
%....%..%%.%..%%.%.%
%.%%.%..%%.%%%%...%%
%.%%%.%%%..%%%.%%..%
%%..%.%%.%%..%%%%.%%
%.%..%%%%.%%...%%..%
%%.%%%..%%...%.....%
%...%....%%%%....%.%
%%.%.%%%..%%%.%.%.%%
%......%%%%.%.%%%.%%
%.%..%.%..%%....%.%%
%.......%...%..%%..%
%%%%%%%%%%%%%%%%%%%%
