%%%%%%%%%%%%%%%%%%%%
%%P........%%...%..%
%%.%%..%%%....%%%%.%
%%...%%..%%..%..%..%
%..%...%..%%%%%....%
%%%%%..%.%.......%.%
%.%.%.%%...%.%%%...%
%.......%.%...%..%.%
%.%.%.....%...%%...%
%...%%..%..%...%..%%
%%%%%%.%.%...%.....%
%%%......%..%%..%.%%
%...%%%.%.%......%.%
%%.%%.......%%%....%
%....%%%.%%%...%%.%%
%%%%.%.....%%%.%.%.%
%%%%..%%%...%......%
%....%..%.%....%..%%
%.%..%%...%.%..%..%%
%%%%%%%%%%%%%%%%%%%%
