%%%%%%%%%%
%P.....%.%
%.%.%%...%
%.%....%.%
%..%%.%..%
%.%%...%.%
%..%.%.%.%
%.%.%%.%.%
%......%.%
%%%%%%%%%%
