%%%%%%%%%%%%%%%%%%%%
%P....%...%%.%.%%..%
%.%.%.%.%%..%%%...%%
%.%%%%...%%%%.%%..%%
%.%.......%%.%%.%..%
%.%..%%%.%%%.%.%.%.%
%.%.%.%.%%%%.%%%.%%%
%%%.%.%%%%..%%..%.%%
%..%%..%%.%%.%%..%%%
%%.%..%%........%%%%
%..%....%%.%.%.%.%.%
%.....%...%...%%..%%
%%.%%.%.%%.%%....%%%
%...%%%%%%.%%.%%..%%
%%%.%.........%.%%%%
%...%.%%..%.%...%..%
%%..%.%..%%..%%%..%%
%.%.%.%%%...%..%%%%%
%..%.%.%..%.%%..%..%
%%%%%%%%%%%%%%%%%%%%
