%%%%%%%%%%%
%P...%....%
%.%.%%.%%.%
%.%%%..%%.%
%.%.%...%.%
%.%%%%.%..%
%.%.....%.%
%.%%..%.%%%
%.%%.%%..%%
%%.%%.%...%
%%%%%%%%%%%
