%%%%%%%%%%
%P%%.%...%
%..%...%%%
%....%%..%
%.%%%%%%%%
%....%%%.%
%%.%%%%.%%
%%.%.%%.%%
%...%.%.%%
%%%%%%%%%%
