%%%%%%%%%%
%P...%%.%%
%%.%..%%%%
%..%%..%.%
%.%%..%%%%
%..%..%.%%
%.%.%%%..%
%....%...%
%%.%.%%..%
%%%%%%%%%%
