%%%%%%%%%%%%%%%%%%%%
%P.....%....%.%.%..%
%.%..%.%%%.%..%.%%%%
%.%%%.%..%......%%%%
%.%...%....%%%%%..%%
%..%%.%.%...%.....%%
%%%%.%.%%%%%.%..%%.%
%.....%%%%...%.%.%.%
%%%..%%..%..%%..%%%%
%..%%%%....%%%%%%%.%
%.%%%.%...%..%.%%..%
%.%.%%%%%%..%.%%%..%
%.%%.%.%.%.%.%.%..%%
%%%..%%%...%.......%
%.%%%%.%.%%.%%..%.%%
%%...%....%..%%....%
%....%%.%.%..%%..%.%
%%%.%%.....%.%.%%..%
%%%...%%.%.%..%..%%%
%%%%%%%%%%%%%%%%%%%%
