%%%%%%%%%%%
%P...%.%..%
%%..%%.%..%
%%.%%.%%..%
%.....%.%.%
%.%.%%%%%%%
%%..%..%..%
%.%.%%%%%.%
%.%.%..%.%%
%.....%%..%
%%%%%%%%%%%
