%%%%%%%%%%%%%%%
%%P%%...%.....%
%...%%..%.%%..%
%..%%..%%.%%%.%
%.%.%....%%.%.%
%.....%%%..%%%%
%..%%%..%.%...%
%.%%.%.%%...%%%
%..%..%%%.%.%.%
%......%..%%..%
%.%.%%.%.%%%%%%
%.%%.%%..%.%%%%
%%%.%.%%.%%%..%
%..%......%..%%
%%%%%%%%%%%%%%%
