%%%%%%%%%%
%P.......%
%.%.%.%%.%
%.%.%%%..%
%.%.%.%%%%
%.%.%.%..%
%.....%.%%
%.%.%....%
%.....%..%
%%%%%%%%%%
