%%%%%%%%%%%%%%%
%%P.....%.%.%.%
%..%.%%...%.%.%
%%%%%%%%.%..%.%
%%...%.%%.%%..%
%%.%%.....%.%.%
%.....%.%%%.%%%
%.%%%.%..%.%.%%
%%%...%..%%%%%%
%...%%...%....%
%%%%%.%%%...%.%
%%.%.%...%%.%%%
%%.%%%..%%..%.%
%...%.%%.%..%.%
%%%%%%%%%%%%%%%
