%%%%%%%%%%%%%%%
%P...%.%.%....%
%.%.%..%%..%.%%
%%..%%.%..%%..%
%...%..%%%...%%
%.%%%%%...%%..%
%.%...%.%%.%%.%
%.%%.%%%%%..%%%
%....%.%..%%%.%
%.%.%.%%.%..%%%
%.%..%%.%.%%.%%
%..%%..%.%.%.%%
%.%.%%.%..%%%.%
%..%.%......%.%
%%%%%%%%%%%%%%%
