%%%%%%%%%%
%P%%...%.%
%%%.%%.%%%
%.%.%.%%%%
%%%%...%.%
%%.%..%..%
%.%.%.%%%%
%.%%.....%
%.%..%..%%
%%%%%%%%%%
