%%%%%%%%%%%%%%%%%%%%
%P%.%......%..%..%.%
%...%%....%..%%...%%
%%%..%%%....%%.%%.%%
%.%%%%..%%%...%.%%%%
%.%.%..%%%.%.%%%..%%
%%%%%%..%%%.%%%.%%.%
%.%%.%..%%%.%.%.%.%%
%.%.....%.%.%%...%%%
%..%.%%%.%.%...%%%%%
%.%%..%%.%.%%%.%...%
%...%%.%.%%%%.%%...%
%.%%%.%....%.%%..%%%
%.....%%%%%%...%..%%
%.%%...%.%%%.%..%..%
%..%.%%.%.%%%.%..%%%
%%%%%%...%.....%..%%
%%%..%%..%%.%..%.%.%
%%.%........%%%....%
%%%%%%%%%%%%%%%%%%%%
