%%%%%%%%%%
%%P......%
%..%.%.%.%
%%%%.%...%
%%%....%.%
%.%.%%.%.%
%...%....%
%.%...%%.%
%...%....%
%%%%%%%%%%
