%%%%%%%%%%%
%P..%..%.%%
%%%%%.%%%.%
%.%%....%.%
%....%%%%.%
%.%%%..%%%%
%.%.%%%%%.%
%....%.%%.%
%%.%.....%%
%..%%%....%
%%%%%%%%%%%
