%%%%%%%%%%%%%%%
%P............%
%.%%.%%%%%..%.%
%.......%..%..%
%.%.%%%.%%%.%.%
%...%.....%.%.%
%.%%%.%.%.%.%.%
%..%..%.....%.%
%.%%%...%.%%..%
%..%.%%.%%...%%
%%...%......%.%
%..%.%.%..%...%
%.%.%...%..%.%%
%.%...%...%...%
%%%%%%%%%%%%%%%
