%%%%%%%%%%
%P..%....%
%......%.%
%.%.%%%..%
%..%.%..%%
%......%.%
%.%......%
%..%..%%.%
%%.%.....%
%%%%%%%%%%
