%%%%%%%%%%
%P%....%.%
%.%....%.%
%.%.%%...%
%...%..%.%
%%.%.....%
%%...%...%
%%.%.%.%%%
%..%.%...%
%%%%%%%%%%
