%%%%%%%%%%%
%P..%..%..%
%.%.....%.%
%.%.%.%%%.%
%.%.%...%.%
%.%%%%.%..%
%.%.....%.%
%%%%%.%.%.%
%.%..%%..%%
%%..%....%%
%%%%%%%%%%%
