%%%%%%%%%%%%%%%%%%%%
%P%...%.%..%.%..%..%
%.%.%%.%.....%%%%%.%
%%%.%%.%%%...%..%..%
%...%%..%%%%.%.%%%%%
%..%%....%%.%.%....%
%.%.%%.%.%%.%..%%..%
%%.%%.%%%%...%%%..%%
%%%%...%.%.%%%.%%..%
%.......%%...%...%.%
%.%..%%.%.%.%.%%%.%%
%..%.%..%....%%.%%.%
%.%.%.%%...%.%%.%%.%
%..%..%.%...%.%.%..%
%.%%%....%...%.%..%%
%%%..%.%%....%%%%%.%
%.%.%.%%.%......%%.%
%.%%.%%.%%.%%......%
%%.%%%.......%%%..%%
%%%%%%%%%%%%%%%%%%%%
