%%%%%%%%%%%%%%%
%P...%%....%.%%
%.%.%%.%..%%..%
%.%%...%..%..%%
%%.%..%%%.%%..%
%..%%..%.%%.%%%
%%%%...%.%.%.%%
%.%....%..%%.%%
%.%%..%%%%%.%.%
%%%..%.%.%%...%
%.%%%.%......%%
%.%%.%.%%%.%%.%
%.%.%%%%.%%...%
%..%.%.%%.%.%%%
%%%%%%%%%%%%%%%
