%%%%%%%%%%
%%P......%
%..%...%%%
%.%.....%%
%.%%..%.%%
%.....%%.%
%...%%.%.%
%.%%%%%..%
%...%...%%
%%%%%%%%%%
