%%%%%%%%%%%%%%%
%P%%.%..%%.%.%%
%%...%..%.%%..%
%%%%.%%..%%..%%
%..%..%%%%..%.%
%%%..%..%.%%..%
%.....%%.%....%
%%.%%.%%%%%.%%%
%%%%%%.%%.%%%%%
%..%..%..%.%%.%
%.%%%..%..%.%%%
%%.%%.%....%..%
%..%%.%%%.%.%%%
%.%.....%..%%.%
%%%%%%%%%%%%%%%
