%%%%%%%%%%%%%%%%%%%%
%P%...%.%..%.%..%.%%
%.%.%%..%.....%.%%.%
%%%.%%.%%%....%..%.%
%...%%..%.%%%.%%%%.%
%...%....%%.%.%.%.%%
%.%.%%.%.%%.%..%...%
%%.%%.%%%%...%%.%.%%
%%%%...%.%.%%.%..%.%
%....%...%....%%%%.%
%.%..%%.%.%.%.%%..%%
%...%%.%.....%..%..%
%...%%...%%%.%%.%%.%
%.%..%.%......%%%.%%
%..%%...%%...%.%%.%%
%.%.%.%.%%%%.%%%%%.%
%.%.%.%..%%.....%%.%
%%%%%%.%%..%%......%
%......%.....%.%.%%%
%%%%%%%%%%%%%%%%%%%%
