%%%%%%%%%%%%%%%
%P.......%....%
%.%%%%%%%..%.%%
%..%%..%%.%%..%
%...%.%.%%...%%
%.%.%%%%%.%.%.%
%.%.%.%..%.%%.%
%.%%.%%%%%....%
%.........%.%.%
%.%.%%.%%%..%%%
%.%%.%%.%.%%..%
%%.%%..%.%.%.%%
%...%.%...%%..%
%..%..%.%...%.%
%%%%%%%%%%%%%%%
