%%%%%%%%%%%%%%%%%%%%
%P%.....%...%..%...%
%...%...%.%.....%..%
%%%..%%%%.%.%.%.%.%%
%.%%%%..%%.%.%.....%
%.%.%..%%%.%%%%%.%.%
%..%%%..%%%%%....%.%
%.%%.%.%.%.%%.%...%%
%.%.......%...%%..%%
%%...%.%%..%...%%.%%
%%.%.%%%.%.%%..%...%
%...%.%..%%%%.%%%..%
%%%%%%.%.%.%.%%%.%%%
%..%.%%%%%%%.%..%.%%
%.%%%.%..%%%.%..%..%
%.%.%%..%.%%%.%...%%
%....%.%%%.....%..%%
%%%%..%..%%.%..%%%.%
%..%%%........%....%
%%%%%%%%%%%%%%%%%%%%
