%%%%%%%%%%%
%P%.....%.%
%.%%.%.%.%%
%.%..%....%
%...%.%%..%
%%%......%%
%.%.%.%%.%%
%.........%
%%.%%.%.%%%
%.........%
%%%%%%%%%%%
