%%%%%%%%%%
%P.%%.%..%
%.......%%
%%%%.%...%
%.%%.%%..%
%.%%.%%..%
%..%.%.%.%
%.%..%%%.%
%....%%..%
%%%%%%%%%%
