%%%%%%%%%%%
%P%%...%%.%
%..%%.%.%%%
%.%%%%%%%.%
%..%%%.%..%
%%.%%.%%%.%
%.%%%%.%%.%
%.%...%%.%%
%.%%%%%.%%%
%%%....%%.%
%%%%%%%%%%%
