%%%%%%%%%%%
%P......%.%
%%%%%%%...%
%...%.%.%.%
%.%...%.%.%
%..%%.%%..%
%%%......%%
%.%%.%%%..%
%..%..%..%%
%%...%%...%
%%%%%%%%%%%
