%%%%%%%%%%%
%P........%
%.%%%%%%%.%
%....%...%%
%.%%...%..%
%.%..%%%.%%
%.%%......%
%....%%.%.%
%.%%....%.%
%...%.%...%
%%%%%%%%%%%
