%%%%%%%%%%%%%%%%%%%%
%P.%.%.%%.%.%.%.%.%%
%..%%%...%..%.%%...%
%%%..%.%.%%%..%%%%.%
%...%...%%.%.%....%%
%..%%%.%%......%%%%%
%...%....%.%%.%.%%.%
%...%.%.%..%.%...%.%
%%%...%%%%%.%.%.%..%
%.%%%.%....%.%%.%%%%
%%.%%%.%.%.%%%...%%%
%%.%%.....%%%%%.%.%%
%%.%...%%..%..%%%%.%
%..%.%...%%%%%.%%%.%
%...%%%%%%%.%..%.%%%
%%.%.%..%%%.%%.%...%
%...%..%%.%%.%.%%%%%
%.%.%%%..%.%....%%.%
%.%%..%..%.%..%.%..%
%%%%%%%%%%%%%%%%%%%%
