%%%%%%%%%%%%%%%
%P.%...%...%..%
%.....%%%%%.%%%
%%...%.%%...%.%
%%..%...%.%...%
%.%%%%%%%.%.%%%
%.%...%%%%..%.%
%.%%.....%%.%.%
%..%.%....%.%%%
%.%%%%%%%.%.%%%
%%%%%...%%.%%.%
%.%.%%....%%.%%
%%.%%.%...%..%%
%..%%.%.....%.%
%%%%%%%%%%%%%%%
