%%%%%%%%%%
%P%....%.%
%.%...%..%
%.......%%
%.%%.%%..%
%.....%%.%
%%%%.%...%
%......%.%
%.%...%%.%
%%%%%%%%%%
