%%%%%%%%%%%%%%%%%%%%
%P..%.%%..%....%...%
%.%%%%.%%%%%%%...%.%
%.%%...%%.%%.%.%...%
%%%.%.%%...%..%..%.%
%...%%%...%%..%.%..%
%.%%%%%...%..%...%.%
%.%.%.%.%%%%.%.%.%%%
%.%.%%..%.%.%%.%%%%%
%.%..%..%%%%%%%%..%%
%.%%%.%%.%.%.%%.%%%%
%.%%%%%.%%%%.%.....%
%.%.%.%%.%.%.%.%.%.%
%.%.%%..%.....%.%%%%
%%..%%.%%....%%....%
%.%.%%%%.%%%.%.%%%.%
%%%%%..%%%.%%.%%%.%%
%%.%.%%.%.%%...%%%.%
%..%..%.....%..%.%%%
%%%%%%%%%%%%%%%%%%%%
