%%%%%%%%%%%%%%%
%P............%
%.%%.%.%%%%%%.%
%.%%.%%%....%%%
%.%......%%...%
%.%.%.%%%...%%%
%.%......%%...%
%...%%%.%.%%%.%
%.%.........%.%
%.%.%%%%%%%.%.%
%.%.......%.%.%
%...%.%.%.%.%.%
%.%..%.....%%.%
%..%...%.%....%
%%%%%%%%%%%%%%%
