%%%%%%%%%%%%%%%
%P.%..%..%.%%%%
%%%.%%%%%..%.%%
%.%%%...%%..%%%
%.%...%%...%%.%
%.%.%..%.%%%..%
%.%...%%.%.%.%%
%%%%%.....%%.%%
%....%.%..%.%.%
%%%..%%%.%.%%.%
%..%....%%..%.%
%....%.%..%.%%%
%.%%.%%%.%%.%%%
%..%.%.%%.%%..%
%%%%%%%%%%%%%%%
