%%%%%%%%%%%
%P..%%..%.%
%.%..%%.%.%
%.%.......%
%..%.%%.%%%
%%.%%.....%
%..%%..%.%%
%..%...%..%
%..%.%.%%%%
%.%.......%
%%%%%%%%%%%
