%%%%%%%%%%%%%%%
%P.........%..%
%.%%.%%%%%..%.%
%..........%..%
%.%.%%%.%%%...%
%.......%...%.%
%.%%.%%.%.%...%
%.....%...%.%.%
%.%%%...%.%%..%
%..%.%%.%%%..%%
%%..........%.%
%..%.%.%%.%...%
%.%%%...%..%.%%
%.%...%...%...%
%%%%%%%%%%%%%%%
