%%%%%%%%%%%%%%%
%P............%
%.%%%%%.%..%.%%
%.%..%...%....%
%...%%%%...%%.%
%.%.%....%....%
%....%%%..%.%.%
%%.%%%.%.%%.%.%
%..%......%%..%
%.%.%.%.%...%.%
%.%.%....%.%%.%
%.....%%%..%..%
%%.%%..%.%.%%.%
%.....%.......%
%%%%%%%%%%%%%%%
