%%%%%%%%%%%%%%%
%P............%
%.%%%%%.%..%.%%
%.%..%...%....%
%...%%%%...%%.%
%.%.%....%....%
%....%.%..%%%.%
%%.%%%%%%%%.%.%
%...%..%..%...%
%.%.%.%.%...%.%
%.%.%...%%.%%.%
%.....%....%..%
%%.%%..%.%.%%.%
%.....%.......%
%%%%%%%%%%%%%%%
