%%%%%%%%%%%%%%%
%P............%
%.%%%%%.%..%.%%
%.%..%...%....%
%...%%%%...%%%%
%.%......%....%
%....%%%..%.%.%
%%.%%%.%.%%...%
%..%......%.%.%
%.%.%.%.%...%.%
%.%.%....%.%%.%
%.....%%%..%..%
%%.%%..%.%.%%.%
%...%.%.......%
%%%%%%%%%%%%%%%
