%%%%%%%%%%%%%%%
%P............%
%.%%%%%.%..%.%%
%.%..%...%....%
%.%.%%%%...%%.%
%.%.%....%....%
%....%.%..%.%.%
%%.%%%%%%%..%.%
%...%..%..%...%
%.%.%.%%%...%.%
%.%.%...%%%%%.%
%.....%....%..%
%%.%%..%.%.%%.%
%.....%....%..%
%%%%%%%%%%%%%%%
