%%%%%%%%%%%%%%%
%P............%
%.%%%%%.%..%.%%
%.%..%...%....%
%.%.%%%%...%%.%
%.%......%%...%
%....%.%..%.%.%
%%.%%%%%.%%...%
%...%.....%.%.%
%.%.%.%.%...%.%
%.%.%...%%.%%.%
%.....%....%..%
%%.%%..%.%.%%.%
%...%.%.......%
%%%%%%%%%%%%%%%
